a 'bras|le 'fruit d'A' (n296), (sorte de fruit d'apparence semblable aux excroissances bulbeuses d'un érable)
a la la|Quelle joie ! Quelle merveille ! C'est merveilleux ! Formidable !
'a shad|A court, comme un A en signe de ponctuation c'est-à-dire un trait avec une boule au sommet (n319)
a ti|Atiyoga (syn. Dzogchen)
a ti yo ga|Atiyoga (syn. Dzogchen)
'ar gtad|contempler fixement (p88), viser, diriger les yeux (ou l'attention) vers, intégration
'ar la gtad pa|contempler fixement (p88), viser, diriger les yeux (ou l'attention) vers, intégration
b+ha sing|(le grand charnier) Bhasing (p15)
bad kan|phlegme (p58)
bad rtsol mi dgos pas|"l'effort acharné n'étant pas nécessaire, la vigueur de l'effort étant superflue, efforts et tentatives étant inutiles ; il n'est pas nécessaire de s'échiner avec effort"
'bad rtsol bya mi dgos|"l'effort acharné n'étant pas nécessaire, la vigueur de l'effort étant superflue, efforts et tentatives étant inutiles ; il n'est pas nécessaire de s'échiner avec effort"
bag chags|vâsanâ, propension, tendances, traces karmiques, résidus karmiques, propensions inconscientes, schémas habituels
bag chags kyi phung po|les constituants procédant des habitudes (n312)
bag yangs|à son aise, à l'aise, décontracté, qui ne s'en fait pas
ban bun|(les apparences) évanescentes (p102)
bar chad med pa|sans obstacle, sans interrumption, sans empêchement
bar chad med par|sans obstacle, sans interrumption, sans empêchement
bar do|antarâbhava, l'état intermédiaire, le bardo, l'entre-deux, transition
bar med|ininterrompu
bca' ba|continuer
bcom ldan 'das|le Bienheureux, « le subjugueur des démons, détenteur des excellentes qualités, transcendant les extrêmes du samsâra et du nirvâna »
bcos med|sans artifices, sans fabrication, sans interférence, sans tentative de correction, non traité, non modifié, non corrigé, sans productions, inaltéré, non fabriqué, sans arrangement(s)
ma bcos pa|sans artifices, sans fabrication, sans interférence, sans tentative de correction, non traité, non modifié, non corrigé, sans productions, inaltéré, non fabriqué, sans arrangement(s)
bcos su med pa|sans artifices, sans fabrication, sans interférence, sans tentative de correction, non traité, non modifié, non corrigé, sans productions, inaltéré, non fabriqué, sans arrangement(s)
bcos slad med pa|sans fabrication ni altération, , sans artifice ni altération, ni modifié ni altéré, sans modification ni corruption
bcos su med pa|n'ayant rien à améliorer, sans correction à apporter
bcud len|l'absorption de la sève (n268), extraction de la quintessence
bdag 'dzin|âtmagraha, saisie d'un soi, saisie égotique, la saisie de l'ego, réifier, se prendre pour sujet, se percevoir comme (ayant) une identité (en soi)
bdag tu 'dzin pa|âtmagraha, saisie d'un soi, saisie égotique, la saisie de l'ego, réifier, se prendre pour sujet, se percevoir comme (ayant) une identité (en soi)
bdag med|Anâtman, non soi, sans personne, sans soi, non ego, sans moi, absence de soi, absence d'ego, insubstantiel
bdag nyid|en soi (p86), la propriété fondamentale (p97), identité
bdag nyid chen po|le grand en soi, la grande propriété fondamentale, la personne authentique, grand être, mahâtma, grande nature
bde ba|félicité, bonheur
bde ba chen po|Mahâsukha, grande félicité, (état de) suprême félicité
bde chen|Mahâsukha, grande félicité, (état de) suprême félicité
bde ba'i nyams|expérience de félicité
bde drod|la 'félicité-chaleur' (p30), chaleur-félicité (p93)
bde gshegs|Sugata, Parti en la félicité, Celui qui s'en est allé dans la félicité, Bienheureux
bde bar gshegs pa|Sugata, Parti en la félicité, Celui qui s'en est allé dans la félicité, Bienheureux
bde phril|une expérience de félicité qui vous fait complètement frémir (p105)
bde sang nge|le bonheur d'une transparence pure et ouverte (p105)
bden med|l'irréalité (p98), sans réalité, sans existence réelle
bden med yo lang|le jeu de l'irréalité (p98), le jeu continuel et sans obstruction de l'irréalité, le jeu du sans existence réelle
bden pa gnyis|les deux réalités, les deux vérités
bden pa mthong ba|voir la réalité, voir la vérité
bdud|nuisance, obstacle, démon
bgegs|les facteurs d'interruptions (p78), obstacles, empêchements
bka'|verbe, injonction, parole (du Bouddha)
bka' babs|filiation (p18), transmission orale
bka' ma|tradition orale
bla ma|Lama, maître, Père-Mère de bonté
bla ma'i gdams ngag la bsam pa|(l'entrainement de l'esprit) basé sur la considération des instructions du Lama (p29)
bla ma'i rnal 'byor|guru yoga, yoga du lama, unifier (l'Esprit) du maître (et le sien)
bla med|anuttara, insurpassable, sans supérieur, que rien ne surpasse, suprême entre tous, incomparable, que rien n'excelle
bla na med pa|anuttara, insurpassable, sans supérieur, que rien ne surpasse, suprême entre tous, incomparable, que rien n'excelle
bla na med pa'i rgyud|Anuttaratantra
bla sgrub|pratiques extraordinaires du lama' (p81), sâdhana du Lama
blang dor|rejeter ou appréhender (p75)
blang dor med pa|sans rejeter ou appréhender (p75), absence d'acceptation ou de rejet, n'a rien à voir avec l'acceptation ou le rejet, n'implique ni acceptation ni rejet
blang dor med par bskyang ba|continuer sans rejeter ou appréhender
blo|intellect, intellection, esprit, pensée, attitude, esprit ordinaire, conscience ordinaire
blo bde|l'esprit heureux, sans souci, bienheureux
blo byas bcos ma'i lta sgom|vue et méditation fabriquées (ou élaborées, façonnées, forgées, produites, engendrées) par l'intellect
blo byas 'jur dran|l'enchevêtrement des souvenirs produits par le mental, inextricable tissu des mémoires fabriquées par l'intellect (ou l'esprit, l'esprit conceptuel)
blo chung skal dman|les moins fortunés dotés d'une intelligence moindre
blo 'das brjod bral|transcendant l'intellect et au-delà de l'expression par des mots (ou verbale), transcender l'intellection et sans mots, impensable et inexprimable, au-delà des concepts comme des mots, dépasse l'esprit ordinaire et est au-delà de l'expression
blo gros|mati, intellect, intelligence intellectuelle, 'd'esprit vif'
blo ldog rnam bzhi|les quatre pensées qui détournent du samsâra, les quatre pensées qui transforment notre attitude (envers la vie mondaine)
blo rab skal ldan|les fortunés doués de la plus haute intelligence
blo sbyong|entraînement de l'esprit (p109)
blugs pa|remplissage (au sens où la consécration fait voir clairement la présence naturelle des trois corps du fond en soi, à demeure depuis toujours) (p19)
bog 'don|les (moyens d')amplification(s) (de la pratique) (p96), amplifier la pratique (p97)
bras bu|le fruit, le résultat, les conséquences
bras bu'i rdo rje theg pa|le vajrayana ou le véhicule du fruit
bras bu'i theg pa|le véhicule du fruit, le véhicule résultant
brda brgyud|transmission par symboles, lignée symbolique
brda bzhi|les quatre signes
brda chad|les signifiants (p97), désignations
brda|symbole, signe
brda'|symbole, signe
brel ba|connecté, lié, interconnecté, relié, relation interdépendante (entre les choses)
brgyud pa|lignée de transmission, lignée
brgyud pa'i bla ma|maîtres de la lignée, Lamas de la lignée de transmission
brjod med|inexprimable, indicible, ineffable, inénarrable, indescriptible (avec des mots)
brjod med kyi rig pa zang thal|inexprimable intelligence immédiate ouverte, transparente et sans entrave, ouverture transparente et sans entrave de l'indicible état d'intelligence en soi
brtag pa|examiner
brtan pa thob|obtenir (ou atteindre) la stabilité
brten|supporté (p97)
brtse ba|amour, aimer
brtsis med|sans calcul, sans calcul ni intention
rtsis med|sans calcul, sans calcul ni intention
rtsis gdab med pa|sans calcul, sans calcul ni intention
brtson 'grus can|les pratiquants diligents (p108)
brtson sgrus|énergie, diligence, courage, vaillance, vigueur
bsam gtan|dhyâna, stabilité spirituelle (p101), la concentration, la stabilité du pensé ou de l'esprit pensant, stabilité de l'esprit (n175), concentration, méditation, niveau de concentration, stabilité méditative
bsam gtan gyi mkhan po|un maître de Zen
bsam gtan gyi rgyu tshogs|développer les causes de la stabilité de l'esprit
bsam gtan gyi zhag lnga|les cinq jours de stabilité spirituelle (p101) ), (ou de la concentration, la stabilité du pensé ou de l'esprit pensant, stabilité de l'esprit, concentration, méditation, niveau de concentration, stabilité méditative)
bsam pa'i shes rab|compréhension issue de la réflexion (sur les enseignements)
bsam yul kun las 'das pa|au-delà de tout objet imaginable, au-delà de tout objet de l'imagination, au-delà de tout ce que l'on peut imaginer
bsam|vivre (au sens d'expérimenter, ex. lors d'une initiation) (p39), expérimenter (p102), concepts, considérer, réfléchir à
bsam pa|vivre (au sens d'expérimenter, ex. lors d'une initiation) (p39), expérimenter (p102), concepts, considérer, réfléchir à
bsgom med|non méditation, n'a pas besoin d'être cultivé, sans nécessiter de familiarisation
ma bsgoms|non méditation, n'a pas besoin d'être cultivé, sans nécessiter de familiarisation
bsgom pa chen po|la grande méditation, méditation suprême
bsgrub pa|établir, affirmer, créer, atteindre
bsgyur|"1.s'habituer (p98) ; 2.se détériorer"
bsil ba'i tshal|(le grand charnier du) Frais Bosquet (p14) (près de Bodhgaya)
bsil sbyin|(le grand charnier) Donnant la Fraîcheur (p14)
bskyed rdzogs|transformation/perfection, utpattikrama/sampannakrama (p113, n14), les processus (ou phases) de génération et de perfection
bskyed rdzogs zung 'jug|l'union des phases de transformation et de perfection, transformation et perfection non deux
bskyed rim|transformation, utpattikrama (p113), phase de génération, processus de génération, étapes de production, phase de développement, processus de visualisation
bskyed pa'i rim pa|transformation, utpattikrama (p113), phase de génération, processus de génération, étapes de production, phase de développement, processus de visualisation
bsod nam gyi tshogs|développement de bienfaits
bsod nams|punya, bienfaits
bstan bcos|traité (commentant la parole du Bouddha)
bstan pa|enseignement, exposé, 'ce qui est montré'
bsu skyel|l'arrivée et le départ (p104)
btag grol|libération par le port, libération en portant (sur soi)
btang bzhag med pa|sans rien éliminer ni positionner, sans rien rejeter ou adopter
"btsal ba med pa; "|qui ne nécessite pas d'être cherché (ou recherché), sans devoir être cherché, qu'il n'y a pas lieu de chercher
ma btsal|qui ne nécessite pas d'être cherché (ou recherché), sans devoir être cherché, qu'il n'y a pas lieu de chercher
bu'i 'od gsal|la claire lumière 'enfant'
bum can|bumchen, kumbhaka (p30), respiration vase
bya ba'i rgyud|Kriyatantra
bya ba'i rgyud kyi theg pa|véhicule du Kriyatantra
bya bral|non action, non agir, libre d'action, sans activité, libération de toute activité (conceptuelle)
bya rtsol med pa|sans besoin de s'efforcer à faire, n'impliquant pas d'effort fastidieux
bya rtsol|faire effort en une activité, activités et effort, réagir, effort délibéré, effort volontaire, accomplissement laborieux, effort fastidieux
bya ba dang rtsol ba|faire effort en une activité, activités et effort, réagir, effort délibéré, effort volontaire, accomplissement laborieux, effort fastidieux
byams pa|un égarement (p95)
byan tshud pa|expérience personnelle vécue, obtenir la maîtrise par l'expérience personnelle
rang byan tshud pa|expérience personnelle vécue, obtenir la maîtrise par l'expérience personnelle
byang chub sems dpa'|Bodhisattva, héros pour l'éveil, vaillant à l'esprit d'éveil, vaillant pour l'éveil, chevalier d'éveil
byang chub sems dpa'i theg pa|véhicule des bodhisattvas
byang sems|bodhicitta, l'esprit d'éveil, l'éveil de l'esprit du cour, cour-esprit éveillé, cour-esprit d'éveil
byang chub kyi sems|bodhicitta, l'esprit d'éveil, l'éveil de l'esprit du cour, cour-esprit éveillé, cour-esprit d'éveil
byang chub sems|bodhicitta, l'esprit d'éveil, l'éveil de l'esprit du cour, cour-esprit éveillé, cour-esprit d'éveil
byar med|en lequel il n'est rien besoin de faire
byar med skyes bu|une personne qui n'a rien de plus à faire
byas pa|acte délibéré, action volontaire
byas pa tham cad don med|l'expérience de l'inanité de toutes nos activités (p27)
byed pa po|kartri, créateur, artisan créateur
byin rlabs|adhishthâna, consécration (p39), énergie spirituelle, 'vagues de clarté', une ondée d'inspiration, un rayonnement d'inspiration, bénédiction, influence spirituelle, inspiration, grâce, être inspiré (n169)
bying ba|torpeur
byung ba lnga'i rnal 'byor|le yoga des cinq éléments (p109)
byung bzhi'i sgra don|le sens des quatre éléments (p108)
byung gzhi|le fond d'où tout survient (ou surgit, jaillit), le gisement de base, le gisement à la base de tout, la base d'émergence (de toute chose), le bassin d'émergence de tout
thams cad 'byung ba'i gzhi|le fond d'où tout survient (ou surgit, jaillit), le gisement de base, le gisement à la base de tout, la base d'émergence (de toute chose), le bassin d'émergence de tout
byung 'jug med pa|sans l'avènement ni l'implication en/de (quelque chose)
byung sa med|ne viennent de nulle part, ne surgissent de nulle part
bzang ngan med pa|sans mieux ni pire, aucun n'est mieux ou pire, sans bon ni mauvais
bzhag pa|"1. demeurer, 'ça reste à demeure' (p38), reposer ; 2. jeter, larguer, laisser ; 3. confier quelque chose (à quelqu'un)"
gzhag pa|"1. demeurer, 'ça reste à demeure' (p38), reposer ; 2. jeter, larguer, laisser ; 3. confier quelque chose (à quelqu'un)"
bzhi cha gsum bral|quatrième temps libre des trois autres (p73)
bzod pa|patience, tolérance, endurance
ce re blta ba|contempler comme en un regard grand ouvert, avec les yeux béants équarquillés (p75), contempler en un regard béant, dépouillé et immobile (p79)
cer re bltas|contempler comme en un regard grand ouvert, avec les yeux béants équarquillés (p75), contempler en un regard béant, dépouillé et immobile (p79)
cer mthong|contempler comme en un regard grand ouvert, avec les yeux béants équarquillés (p75), contempler en un regard béant, dépouillé et immobile (p79)
cer re gtad|observer fixement (p86)
chad chod|sans discontinuité (p102), ininterrompu
chad lta ba|la vue nihiliste
chags sdang|(les saisies duelles) d'attraction et de répulsion (p93), attirance (ou attrait) et répugnance, désir et dégoût, concupiscence et répulsion, attirant ou repoussant
char ba'i yul|l'objet des appartitions (n268)
char gzhi|la base des apparitions, projet
'char ba'i gzhi|la base des apparitions, projet
char lugs|mode d'apparition
char sgo|la porte des appartitions (n268)
'char ba'i sgo|la porte des appartitions (n268)
char tshul|manière d'apparition, comment (les choses) apparaissent, façon d'apparaître
chen po|grand, total, immense
chi kha'i bar do|bardo du moment de la mort
chings su bcings|cerner la plus grande envergure, embrasser à plus grande échelle, englober sur une portée plus importante, ceindre à plus grande ampleur, être cerné (ou englobé) par la portée (ou l'étendue) de
cho 'phrul|magie (p74), créations
chos|1. Dharma, réalité, 2. les dharmas, phénomènes, 3. Dharma, l'enseignement du Bouddha, (affaires) spirituelles, 4.facteurs
chos 'byung|(le tétraèdre d'un dharmodaya) (p102), (le domaine d'émergence des dharmas) (p102), matrice, source la nature (des phénomènes), source de la réalité, domaine d'émergence de toute chose
chos dbyings|l'immensité toute ouverte, l'ouverture immense (n131), dharmadhâtu, le domaine de toute réalité, le domaine de la réalité (n144), réalité absolue, la dimension de toute existence, l'espace fondamental (ou élémentaire) des phénomènes
chos kyi dbyings|l'immensité toute ouverte, l'ouverture immense (n131), dharmadhâtu, le domaine de toute réalité, le domaine de la réalité (n144), réalité absolue, la dimension de toute existence, l'espace fondamental (ou élémentaire) des phénomènes
chos kun|tous les dharmas, tous les phénomènes (possibles)
chos kyi bdag med|le non soi des phénomènes, l'insubstantialité des phénomènes
chos log|enseignement erroné
chos lugs|tradition spirituelle
chos nyid|la réalité en soi (p73, 74, 76), dharmatâ, (p97), la réalité de la nature des phénomènes (p104), la réalité (de l'esprit)
chos nyid bar do|le bardo de la réalité en soi
chos nyid kyi rang ngo skyong ba|cultiver (ou préserver, continuer, maintenir) l'état immanent de la réalité en soi
chos nyid mngon sum|la réalité immédiate (n293)
chos nyid mngon sum gyi snang ba|la vision (ou luminosité) de la réalité en soi (ou véritable) (n127, n274), les/la vision(s) de la réalité immédiate (n268, 276)
chos nyid zad pa'i snang ba|"la vision (ou luminosité) de l'épuisement même de l'apparence de la réalité en soi (n127), la vision de l'épuisement de la réalité en soi (n274), la vision de l'épuisement de la réalité (n285) ; la vision de l'épuisement des imputations de l'intellection en la sphère de la réalité en soi (n285), vision de la résolution des phénomènes au-delà de l'esprit ordinaire, la vision en laquelle les phénomènes sont résolus et la conscience ordinaire est transcendée"
chos zad blo 'das kyi snang ba|"la vision (ou luminosité) de l'épuisement même de l'apparence de la réalité en soi (n127), la vision de l'épuisement de la réalité en soi (n274), la vision de l'épuisement de la réalité (n285) ; la vision de l'épuisement des imputations de l'intellection en la sphère de la réalité en soi (n285), vision de la résolution des phénomènes au-delà de l'esprit ordinaire, la vision en laquelle les phénomènes sont résolus et la conscience ordinaire est transcendée"
chos rnams|les réalités, les qualités (éveillées), les dharmas, les phénomènes
chos sku|dharmakâya
chos sku gcig po'i yo langs bskyang|continuer (ou préserver, maintenir) l'unique état sans blocage ni interruption du dharmakâya, préserver la nature libre, unique et sans cesse du dharmakâya, maintenir  l'unique état sans interruption ni blocage du dharmakâya
chos sku rgyal po'i rtsal|le potentiel (manifeste) du roi dharmakâya, l'exercice du roi dharmakâya
chos sku'i klong du dag pa|purifié en l'immensité (ou l'étendue, la vastitude) du dharmakâya
chos sku'i lta ba|la vue du dharmakâya
chos sku'i yo langs|l'état sans blocage ni interruption du dharmakâya, la nature libre et sans cesse du dharmakâya, l'état sans interruption ni blocage du dharmakâya, le jeu du dharmakâya
chos zad blo 'das kyi snang ba|la vision de l'épuisement des imputations de l'intellection en la sphère de la réalité en soi (n285), vision de la résolution des phénomènes au-delà de l'esprit ordinaire, la vision en laquelle les phénomènes sont résolus et la conscience ordinaire est transcendée
chos zad chen po|le grand épuisement (n127), la grande résolution des phénomènes, le grand épuisement des phénomènes
chu rgyun gyi rnal 'byor|le yoga cours de fleuve (p21), le yoga du cours du fleuve (n317)
chu bo rgyun gyi rnal 'byor|le yoga cours de fleuve (p21), le yoga du cours du fleuve (n317)
ci mdzad khyed shes|« tout ce qui est à accomplir est votre intelligence » (p71), « à votre volonté »
cig car ba|les instantanés immédiats (n193), non gradualistes
cig car 'jug pa|entrer instantanément
cig car|instantané, immédiat
cig char|instantané, immédiat
cir snang rang yin|son état d'existence en soi se manifestant partout
cir yang ma grub|quelque chose n'existant pas en soi de quelque façon que ce soit (p66)
cog bzhag bzhi|les quatre repos imperturbables, les quatre (modes de) laisser être, les quatre impavidités
cog bzhag|(état de) repos imperturbable, laisser être, suspension impassible (ou impavide)
cog gzhag|(état de) repos imperturbable, laisser être, suspension impassible (ou impavide)
da ltar gyi shes pa|la cognition de la présence d'instantanéité (p69, 70), conscience d'instantanéité, présence cognitive de l'instant, cognition d'instant présent, présence du moment instantané
dad pa|confiance, foi
"dag dbyings sgron ma; "|la luminosité de l'immensité pure (n268)
dag pa'i dbyings sgron ma|la luminosité de l'immensité pure (n268)
dag pa|pur
dag snang|(l'expérience) des apparences pures (p96), du monde sacré (p96), vision sacrée (p98), vision pure
dam bca'|assertion, vou, promesse, serment (de l'auteur qui précise son objectif en composant l'ouvrage)
dam bca' btang ba|s'engager à (faire)
dam tshig|lien sacré, samaya (n69), promesse sacrée, promesse solennelle, voeu solennel, engagement solennel, parole d'honneur
dam tshig sems dpa'|l'être de samaya, la déité lien, l'aspect symbolique (qui fait le lien sacré), l'être d'engagement (formel), l'être d'enrôlement
"dang po pa; "|débutant
las dang po pa|débutant
das rjes|testament
dbang|abhisheka, pouvoir, consécration, initiation, habilitation, abhikhinca (p19), confer de pouvoir
dbang bskur|conférer une initiation
dbang bzhi|les quatre initiations
dbang lung khrid|initiation (ou habilitation), transmission scripturaire et instructions (guidance)
dbang phyug|Seigneur, le tout puissant
dbang phyug pa|Shivaïte, pratiquant du Shivaïsme
dbang po|facultés, facultés sensorielles, capacités intellectuelles
dbang po gzhan la rag ma lus pa|ne dépend pas d'autres pouvoirs, sans dépendre de capacités autres
dbang po rab 'bring tha ma|capacités excellentes (ou supérieures, les meilleures), moyennes et inférieures (ou médiocres)
dbang po'i rkyen|circonstances des facultés (p85)
dbu ma|1. milieu, centre, 2. Mâdhyamaka, la Voie Médiane, Voie du Milieu, 3. l'artère centrale Uma (p30), le canal central, Uma, Avadhûti
dbu ma pa|Mâdhyamika, adepte de la voie médiane
dbu ma'i rtsa|Avadhûti, le canal central, l'artère centrale
dbu med|écriture en main courante (p71)
dbye ba|classification (p99), différencier, diviser
dbye bsdu|les catégories (p107), classifications, diviser en catégories
dbyer med|non deux, indissociabilité, inséparabilité, indivisible
dbye ba med par|non deux, indissociabilité, inséparabilité, indivisible
dbyings rig|l'intelligence immédiate de l'immensité (p82, 88), l'immensité intelligente (p92), domaine-intelligence, domaine de l'ouvert habité de l'intelligence (n134), l'indissociabilité de domaine et de l'intelligence, intelligence et domaine (non-deux) (n144)
dbyings rig dbyer med|domaine de l'ouvert habité de l'intelligence non deux (n134), l'indissociabilité de domaine et de l'intelligence, l'union de l'intelligence et du domaine, l'intelligence et domaine non-deux (n144)
dbyings rum|l'immensité matricielle (n268)
dbyings snang|la clarté de l'immensité (p88), clarté de l'espace
dbyings snang rnam dag gi sgron ma|la luminosité de la parfaite pureté de l'immensité de l'apparent (p88), la luminosité parfaitement pure de l'immensité des apparences (n268)
"dbyings; dbying"|dhâtu, le domaine de l'ouvert (p38), l'immensité (p84), la sphère, (grand) espace, dimension, espace fondamental
de bzhin gshegs pa|tathâgata, l'Ainsi allé, celui Parti en l'ansité
de bzhin gshegs pa'i snying po|Tathâgatagarbha, la nature de bouddha (inhérente, innée), la matrice de l'éveil, le germe de l'éveil, l'embryon de tathâgata
de kho na nyid ting nge 'dzin|samâdhi de l'ainsité
de nyid|Tathatâ, ainsité (n337), tathatâ, l'état d'être tel que c'est, réalité
de bzhin nyid|Tathatâ, ainsité (n337), tathatâ, l'état d'être tel que c'est, réalité
de kho na nyid|Tathatâ, ainsité (n337), tathatâ, l'état d'être tel que c'est, réalité
de ring|aujourd'hui (p27)
der dmigs nas|(la récitation) est faite en les expériences (précédemment citées) (p39)
dgag sgrub med pa|sans être entravées ni developpées (p74), sans arrêter ni pratiquer (p75), sans arrêter ni créer (de pensées)
dgag sgrub|(les saisies duelles) d'induction et d'élimination (p93), accepte ou rejette (p98), appréhende ou rejette (p98), rejeter et induire (p98), arrêter et pratiquer (p75), arrêter ou activer, entraver ou produire, stopper ou induire
dgag pa dang sgrub pa|(les saisies duelles) d'induction et d'élimination (p93), accepte ou rejette (p98), appréhende ou rejette (p98), rejeter et induire (p98), arrêter et pratiquer (p75), arrêter ou activer, entraver ou produire, stopper ou induire
dge sdig|vertueux et non-vertueux, vertu et vice, actes positifs ou négatifs
dgongs brgyud|transmission par l'esprit de sagesse, lignée directe par l'expérience éveillée
dgongs gter|trésor (terma) de l'esprit
dgongs pa|"1.la sagesse (p69), l'esprit éveillé (p70), l'esprit (de Samantabhadra) (p105), la cognition éveillée (p107), l'expérience éveillée (n268), pensée éveillée ; 2. intention"
dgos med|(vivre dans) la satisfaction (p98), l'absence de besoin, contentement
dgra bcom pa|destructeur de l'ennemi', arhat, 'soumetteur des ennemis'
di ri ri|un grondement bourdonnant (p78)
dkar 'jam rtsa'i sgron ma|la luminosité du canal blanc souple/tendre/soyeux
dkar lang lang|bouillonnement blanchâtre scintillant (p84)
dkar po chig thub|le remède universel
dkyil yangs po|dimension infinie, vastitude infinie
dmigs bcas|focalisation avec objet (ou référence), fixation encadrée (par)
dmigs bsam bral ba|"libre d'orientation, fixation sans objet, sans le cadre de référence de, sans qu'aucun cadre de référence ne s'applique ; ne peut être pensé comme étant ; libre de tout (cadre de) référence ; sans aucun point de référence ; libre de tout cadre de référence"
dmigs gtad bral ba|"libre d'orientation, fixation sans objet, sans le cadre de référence de, sans qu'aucun cadre de référence ne s'applique ; ne peut être pensé comme étant ; libre de tout (cadre de) référence ; sans aucun point de référence ; libre de tout cadre de référence"
dmigs gtad chos med|"libre d'orientation, fixation sans objet, sans le cadre de référence de, sans qu'aucun cadre de référence ne s'applique ; ne peut être pensé comme étant ; libre de tout (cadre de) référence ; sans aucun point de référence ; libre de tout cadre de référence"
dmigs med|"libre d'orientation, fixation sans objet, sans le cadre de référence de, sans qu'aucun cadre de référence ne s'applique ; ne peut être pensé comme étant ; libre de tout (cadre de) référence ; sans aucun point de référence ; libre de tout cadre de référence"
dmigs pa|orientation (p39), visualisation, conception, imagination, cadre référentiel (ou de référence)
dmigs pa med pa|"libre d'orientation, fixation sans objet, sans le cadre de référence de, sans qu'aucun cadre de référence ne s'applique ; ne peut être pensé comme étant ; libre de tout (cadre de) référence ; sans aucun point de référence ; libre de tout cadre de référence"
dmigs skor|les méditations (p104)
dmigs su med pa|"libre d'orientation, fixation sans objet, sans le cadre de référence de, sans qu'aucun cadre de référence ne s'applique ; ne peut être pensé comme étant ; libre de tout (cadre de) référence ; sans aucun point de référence ; libre de tout cadre de référence"
dngos grub|accomplissement(s), réalisation(s) (spirituelles), siddhi
dngos gzhi|pratique principale, corps de la pratique, corps principal de la pratique, pratique proprement dite, sujet principal
"dngos med; dngos po med pa"|une chose n'existant pas substantiellement (p66), ne pas exister (ex. l'esprit) (p67), insubstantiel, sans substance
dngos po med pa|une chose n'existant pas substantiellement (p66), ne pas exister (ex. l'esprit) (p67), insubstantiel, sans substance
dngos po|quelque chose existant substanciellement (p66), exister (ex. l'esprit) (p67), la réalité (p102), entité, chose concrète, substance
dngos po gsum|les trois catégories temporelles (que sont le passé, le présent et le futur) (p73)
dod 'byung nor bu|la gemme à souhaits
dod yon gyis snam bu|grandes banderoles des gratifications sensorielles (n168)
dod yon lnga|le vécu des cinq sens, les plaisirs des cinq sens
'dod pa'i yon tan lnga|le vécu des cinq sens, les plaisirs des cinq sens
don|artha, la nature (de l'expérience immédiate) (p106), sens, ultime, véritable, réalité, sens réel, bienfait, objectif, but, ultimement significatif, plein de sens, ultimement existant, l'état ultime (de)
don dam|sens, réalité, véritable, ultime, réalité ultime, sens (profond et) authentique
don gcig las ma 'das pa|sans aller au-delà de l'unique réalité, ne pas aller au-delà du sens unique, sans dépasser l'unicité, sans transgresser le sens unique
don gyi lta ba|la vraie vue, vue ultime, vue définitive, vue véritable
don gyi snying po|l'ultime essence-même, l'ultime cour essentiel, l'âme de l'ultime, le véritable cour essentiel
don gyi ye shes|véritable expérience première, prime expérience définitive, cognition primordiale ultime (ou réelle)
don med|inanité, vanité (n88), (actions) absurdes, qui n'a pas de sens, sans raison, en pure perte, futile, inutile, creux, vain, ne veut rien dire
don rnams|les facettes
dpal|glorieux, gloire, abondant, splendide, splendeur, valeur, magnificence, prestige, panache, faste, apparat, succès, éclat
dpe|exemple, métaphore, allégorie
dpe don mthun par|la métaphore correspondant à son sens profond, exemple et signification concordant (ou en conformité, en synchronie, qui coïncident), l'exemple et sa signification sous-jacente étant en harmonie
dpe ris|livre d'illustrations
dpe'i ye shes|gnose analogique, gnose signifiée au moyen d'exemples, expérience primordiale imagée (analogique, figurée, métaphorique, allégorique)
dpyad pa|vicâra, analysé, raisonnement, investigation (analytique)
dpyod pa|analyse, analyser, examiner, investiguer (analytiquement)
drag sngags|mantra courroucé, mantra violent
dran 'dun|cultivé en une 'attention' (p75)
dran med|absence de lucidité, sans lucidité, inconscient, distrait, absent
dran pa rgyun gcod|instructions interrompant le cours de la pensée, faire cesser le cours de la cognition (p109)
dran rig 'char nub med pa|l'absence d'apparition et de disparition des événements de la cognition (p75)
"dran rtog; "|les événements du mental (p72), événements mentaux ou intelligences (p73), pensées et souvenirs (ou mémoires), pensées
dran bsam|les événements du mental (p72), événements mentaux ou intelligences (p73), pensées et souvenirs (ou mémoires), pensées
drang don|neyârtha, sens pédagogique, sens didactique
drang thal le|droit et dégagé (p93)
dren pa'i bla ma|Lama qui guide (sur la voie), mentor, guide spirituel
dri med|nirmala, immaculé
dri ma med pa|nirmala, immaculé
drwa mig|fenêtre en oil de bouf (n165)
drwa phyed|filets sertis, demi guirlandes pendantes et serties de joyaux (n162), frise ornementée
du ba|fumée (signe de claire lumière, n238)
du bral med pa|transcendant l'union comme la séparation (p106), qui ne se forme puis se désintègre, sans union ni séparation (d'avec), qui ne se rassemble ni ne se disperse
'du 'bral med pa|transcendant l'union comme la séparation (p106), qui ne se forme puis se désintègre, sans union ni séparation (d'avec), qui ne se rassemble ni ne se disperse
du byed|samskâras, les facteurs formateurs (p55), formations karmiques, impulsions
du byed kyi las|activités des samskâras, activités des facteurs formateurs, karma engendré par les facteurs formateurs
dul ba|Vinaya, discipline (monastique)
dun pa|la ferme intention (p94), ferme aspiration, ardent désir (de)
dur khrod|charnier, cimetière
dus byas thams cad mi rtag pa'o|tout ce qui est composé est transitoire et impermanent (n85)
dus gsum 'pho 'gyur med pa|sans transition ni changement au travers des trois temps
dus ma byas|la non composition (n341), n'est pas chose composée, non composée
dus ma byas pa|la non composition (n341), n'est pas chose composée, non composée
dwang ma lnga ldan gyi thig le|le tiglé aux cinq sèves (p97), le bindu aux cinq quintessences
dwang|une transparence ouverte (p85), lustre, brillance, clair, pur, limpidité transparente (p70), transparent
dwangs|une transparence ouverte (p85), lustre, brillance, clair, pur, limpidité transparente (p70), transparent
dvangs|une transparence ouverte (p85), lustre, brillance, clair, pur, limpidité transparente (p70), transparent
dwangs pa|une transparence ouverte (p85), lustre, brillance, clair, pur, limpidité transparente (p70), transparent
dwangs ma lnga ldan gyi rtsa|le Canal aux cinq sèves (p97), le canal aux cinq quintessences
dzin med|l'état libre de saisie (p95)
dzin pa|grâhaka, saisie, saisir, concept, appréhender, réifier, prendre, prendre pour, tenir à, percevoir comme sujet, percevoir, sujet (qui appréhende)
dzin pas ma bcings|non emprisonné par la saisie, non contraint (ou lié, attaché, piégé, retenu, attrapé, pris au piège, enchaîné, entravé, attrapé, pris dans les fers, pris dans les chaînes) de la saisie, libre de l'imbroglio avec la saisie
e ma ho|Merveille ! Comme c'est merveilleux !
g.yas g.yon zur mig|le regard latéral en coin, à droite ou à gauche (p83)
g.yeng ba|distraction
g.yo med|non agité
gag bsdams|identifier la portée de, discerner les implications, distinguer au sein d'un contexte, identifier (ou percevoir, constater, comprendre, pénétrer, déceler, déterminer, apprécier) les conséquences (ou effets, la portée, aboutissements, conclusions, corollaires)
'gag bsdam|identifier la portée de, discerner les implications, distinguer au sein d'un contexte, identifier (ou percevoir, constater, comprendre, pénétrer, déceler, déterminer, apprécier) les conséquences (ou effets, la portée, aboutissements, conclusions, corollaires)
'gag tu bsdam pa|identifier la portée de, discerner les implications, distinguer au sein d'un contexte, identifier (ou percevoir, constater, comprendre, pénétrer, déceler, déterminer, apprécier) les conséquences (ou effets, la portée, aboutissements, conclusions, corollaires)
'gag tu bsdams pa|identifier la portée de, discerner les implications, distinguer au sein d'un contexte, identifier (ou percevoir, constater, comprendre, pénétrer, déceler, déterminer, apprécier) les conséquences (ou effets, la portée, aboutissements, conclusions, corollaires)
gang tu'ang ma grub|n'existe pas comme quoi que ce soit (p72)
gang zag|individu, personnes
gang zag gi bdag med|le non-soi de la personne
gang zag snyan brgyud|la transmission orale de personne à personne (ou entre individus)
gcer grol|libération par l'attention nue, libération nue, nue (vision) libératrice
gcer mthong|la nue vision (p19)
gcig dang tha dad bral ba|n'est ni un ni multiple
gcig grol|libération en un état unique, libre en un
gcig po|unité
gcig shes kun grol|connaissance unique qui libère tout, connaître une chose qui tout libère, unique savoir tout libérant, une connaissance libérant tout
gcig thag bcad pa|découvrir un état unique, être certain d'une chose unique (ou d'un état unique), établir la certitude quant à l'état unique
gcig|un, unique, unicité, singularité
gcig pu|un, unique, unicité, singularité
gcun|entraîner (p83), s'entraîner, s'exercer
gdams ngag|instructions essentielles
gdangs|l'éclat de l'énergie (p90), la luminosité de l'éclat (p70, 90), l'énergie (p42, n341), translucidité, translucide, rayonnement, éclat
gdangs 'gag pa med pa|l'énergie sans limite (n341), rayonnement sans fin
gdangs gsal ba|la brillante luminosité de l'éclat
gdeng|sûr, vivre (la vue, méditation et action), confiance, assurance
gdengs|sûr, vivre (la vue, méditation et action), confiance, assurance
gding|sûr, vivre (la vue, méditation et action), confiance, assurance
gding grol thog tu bca' ba|Etabli en la confiance libre (3ème vers du testament de Garab Dorjé) (p70), continuer directement avec assurance (ou confiance) en la libération
gdod ma|origine, premier
gdod ma'i dbyings|l'immensité primordiale (p90), l'ouverture (ou domaine, dimension, espace fondamental, espace élémentaire) primordiale
gdod ma'i gzhi|le fond originel, la base primordiale
gdod ma'i mgon po| dinâtha, protecteur originel, seigneur primordial, premier seigneur et maître, buddha primordial
gdod ma'i rnal 'byor|yoga primordial, yoga originel
gdod nas dag pa|primordiallement pur
gdos bcas|les aspects grossiers (p106), ce qui est substantiel (n313), concret
gdos bcas kyi phung po|les composants grossiers (p106)
gegs sel|évacuation des obstructions (p96), qui dissipe les obstacles (p97) élimination des obstacles (p105)
glo bur|adventice
glo bur ma dag pa|impuretés adventices
gnad|point particulier (p104), (pratique) essentielle, point clé, point essentiel, point crucial, point vital
gnad bkrol|révéler le point essentiel, le point clé ayant été mis au jour
gnad don|le sens réel du point essentiel, le véritable point essentiel, le point crucial ultime, le vrai point clé
gnad du bkrol ba|révéler au sein du point essentiel
gnad du brdeg pa|frapper le point essentiel, toucher le point clé, percuter le point crucial, atteindre au point vital
gnad gcig po|unique point essentiel
gnad gsum ldan pa'i lta ba|la vue dotée des trois points essentiels
gnad kun bkrol ba|révéler le point clé dans son intégralité
gnad ma nor ba|le point essentiel sans erreur, point crucial indubitable
gnas|theme, sujet
gnas lugs|(profond) état (naturel) (p75), état fondamental, le sens de l'esprit, disposition essentielle de l'esprit, condition naturelle, mode d'être
gnas lugs ji lta ba gzigs pa'i ye shes|l'intelligence première qui voit l'état naturel tel qu'il est, la prime expérience qui perçoit directement le sens de l'esprit, la cognition primordiale qui expérimente (ou vit, distingue, contemple, constate) directement l'état fondamental
"gnas med; "|la non-demeure, non-résidence (de l'esprit) (p66),
gnas med pa|la non-demeure, non-résidence (de l'esprit) (p66),
gnas pa med pa|la non-demeure, non-résidence (de l'esprit) (p66),
mi gnas|la non-demeure, non-résidence (de l'esprit) (p66),
mi gnas pa|la non-demeure, non-résidence (de l'esprit) (p66),
gnas sa med|la non-demeure, non-résidence (de l'esprit) (p66),
gnas pa|se reposer, demeurer, rester (immobile, calme, tranquille, sans bouger), état calme, être établi
gnas 'phro|au repos ou dispersé, immobile ou éparpillé, immobilité (à demeure) et projections, repos (tranquille) et émissions, sans bouger ou bien diffus, au repos ou prolixe, à demeure ou éparses, calme ou dissipé
gnas sa med|(les pensées) qui nulle part ne demeurent
gnas tshul|façon d'être, manière (ou mode) d'être, état, disposition, condition, situation
gnyen po|antidote
gnyis 'dzin gyi 'ching ba las 'grol ba|libéré des chaînes de la saisie dualiste
"gnyis 'dzin; gnyis su 'dzin pa"|la saisie dualiste, duel, la saisie duelle
gnyis med|advaya, non deux, non duel, sans dualité
gnyug ma|naturellement, état naturel
gnyug ma lhun grub|l'état naturel spontané (p76)
gnyug ma'i rnal 'byor|yoga de l'état naturel, yoga naturel
go ba|compréhension qui n'est qu'intellectuelle
gol sa|déviation, écueil, terrain de déviation, abîme
gol sgrib|déviations et obscurcissements, embardées et voiles, écarts et confusions, dérives et rajouts de confusion, erreur et voile
goms cha|l'entraînement même (p102)
goms pa'i tshad|le critère d'entraînement (p105)
grags stong|sonorité vide
grel pa|commentaires
gro drug|les six migrations (p99), (les êtres) vivant dans les six conditions, les six mondes, les six sortes de vivants
gro 'ong med pa|sans allée ni venue, ne va ni ne vient
gro sa med|ne vont nulle part, n'ont nulle part où aller
grol ba|libération, liberté, relaxer
grol ba gcig pu|libération unique, unique mode de libération
grol ba'i grong khyer|la cité (ou citadelle, ou bastide) de la libération
grol cha|côté libération
grol cha'i chos sku ngos bzung|reconnaître le dharmakâya du côté de la libération (ou par son aspect de)
grol gzhi|la base de (ou pour) la libération, le fond d'où l'on se libère
grol gzhi'i ye shes ngos 'dzin|reconnaître l'expérience première de la base de la libération
grol lam|voie de la libération (ou de l'auto-libération)
grol lugs|modes de libération
grol lugs bzhi|les quatre modes de libération
grol lugs gsum|les trois modes de libération (p106)
grol sa|l'état de libération, la terre de la liberté
grol sa gcig po yin par ngo shes|reconnaître comme étant l'unique état de libération
grol sa gcig pu|l'unique état de libération
grol tshad|la complète libération (p106), apogée de la libération
grub brgyud|siddhaparamparâ, lignée des accomplis
"grub med; ma grub pa"|n'est pas quelque chose ayant une existence substantielle (p66), incréé, pas réalizé, ne pas servir de/à
grub mtha'|siddhânta, les différentes perspectives de réalisation (p8), système philosophique, doctrines philosophiques, philosophie
grub thob|siddha, accompli, réalisé
grul bum|kumbhânda (p91), troll
gsal ba|une claire lucidité, luminosité, lucidité, lumineuse clarté, claire luminosité, clair, être clairement évident (comme, ou en tant que), être évident, illuminer
gsal ba'i nyams|expérience de clarté
gsal ba'i ye shes|la prime expérience de clarté
gsal cha|la clarté de (son intelligence)
gsal gdab|s'appliquer à la clarté (p100)
gsal 'grib med pa|(apparaître) sans fluctuation (p87), libre de clarté ou d'obscurité, sans (ou libre de, dépourvu de) éclaircissement ni obscurcissement
gsal le|clair et scintillant (p72)
gsal rig|l'éclat de cet état de cette intelligence (p73)
gsal stong|clarté vide (p66), lumineuse vacuité, état de vacuité lucide, luminosité vide
gsal stong dbyer med|clarté vide non deux, indissociabilité de clarté et vide, clarté vide indissociable (ou inséparable)
gsal stong 'dzin med|clarté vide de saisie, clarté naturelle en l'état d'absence de saisie, en état déssaisi (n238)
gsal stong 'gags med|la clarté vide sans obstacle (p79), incessante lumineuse vacuité, état de vacuité lucide sans obstruction, luminosité vide sans obstacle (ou blocage)
gsang ba|secret, intime, aspect secret
gsang ba'i bdag po|le Maître des secrets
gsang ba'i bla ma|Lama secret
gsang mtshan|1. nom secret (reçu lors d'une initiation), 2. parties génitales
gsang sngags|(voie des) mantras secrets
gsang sngags rdo rje theg pa|voie vajra des mantras secrets, véhicule adamantin du mantra secret
gsang spyod|conduite secrète
gsar ma pa|les écoles nouvelles
gseng ma'i phu shu|(syn. de mda' yab) bandeaux sommitaux ornés de motifs floraux (n166)
gshis|l'état fondamental, disposition inhérente, fondamentalement inconditionné
gshis rdzogs pa chen po|l'état fondamental de la Grande Perfection (p76), disposition inhérente de la grande perfection, la grande perfection fondamentalement inconditionnée
gshis shor gyi gol sa|déviation où l'on tombe (ou sort, s'écarte) de l'état fondamental
gtad so|orientation, concept
gtad so dang bral ba|sans orientation, sans point de référence
gtad med|sans orientation, sans point de référence
gtad pa med pa|sans orientation, sans point de référence
gtad tshigs|"conclusion ; critère ; raisonnement"
"gtad; gtad pa "|1. fixation, fixer l'esprit sur, point de référence, intention, induire, induction, se tourner vers, s'orienter vers, 2. confier
gtan la dbab pa|1.amener (rigpa) à son état (de réalisation) définitive (p77), arriver à la stabilité, atteindre la conclusion définitive, 2.systématiser, coucher par écrit de façon standardisée (ou organisée)
gtan la 'bebs pa|1.amener (rigpa) à son état (de réalisation) définitive (p77), arriver à la stabilité, atteindre la conclusion définitive, 2.systématiser, coucher par écrit de façon standardisée (ou organisée)
gtan la phab|1.amener (rigpa) à son état (de réalisation) définitive (p77), arriver à la stabilité, atteindre la conclusion définitive, 2.systématiser, coucher par écrit de façon standardisée (ou organisée)
gtang rgya|sceau de la confiance
gter ma|terma, trésor redécouvert, trésor (caché et découvert), révélation
gter ston|Tertön, découvreur de trésors (termas)
gtong len|accueillir/offrir (n138)
gtor ba|évacuation (ou purification de toutes les empreintes samsariques d'apparences inexistantes) (p19), renvoi, révocation, éviction
gtum mo|toumo, chandâlî (p30)
gur khyim|une tente (p88)
gyin 'dar|la présence naturelle (p76), être 'naturel', être nature
"gyu ba; "|remous, mouvements, agitations mentales
'gyus pa|remous, mouvements, agitations mentales
gyu 'phro'i thog nas|dans l'instantanéité des remous et des projections mentales, dans l'immédiateté (ou l'imminence) des mouvements mentaux et des émissions des pensées
gza' gtad|point de référence, orientation, concepts
gza' gtad dang bral ba|libre de toutes conceptions, libre de tout point de référence, sans orientation
gza' gtad med pa|libre de toutes conceptions, libre de tout point de référence, sans orientation
gzhan du mi rnyed pa'i ye shes|connaissance première qui ne s'obtient nulle part ailleurs qu'en soi, gnose primordiale qui n'est pas trouvée autre part qu'en soi-même, expérience primordiale qui ne se trouve pas à l'extérieur
gzhan ngo snang tshul|le mode d'apparition en tant que perceptions extérieures (à soi), la façon dont les choses apparaissent comme autres ou externes
gzhan rig|conscient de l'autre (ou de l'altérité, cad les objets extérieurs)
gzhi bde|le fond heureux, la félicité de la base, le bienheureux fond d'existence
gzhi bral|sans fondement, sans fond, sans base, sans appui ; sans fondement ni racine, qui n'a ni base ni source ; qui n'a ni fondement ni substance
gzhi med|sans fondement, sans fond, sans base, sans appui ; sans fondement ni racine, qui n'a ni base ni source ; qui n'a ni fondement ni substance"
gzhi med rtsa bral|sans fondement, sans fond, sans base, sans appui ; sans fondement ni racine, qui n'a ni base ni source ; qui n'a ni fondement ni substance
gzhi rtsa med pa|sans fondement, sans fond, sans base, sans appui ; sans fondement ni racine, qui n'a ni base ni source ; qui n'a ni fondement ni substance
gzhi rtsa dngos med|sans fondement, sans fond, sans base, sans appui ; sans fondement ni racine, qui n'a ni base ni source ; qui n'a ni fondement ni substance
gzhi dang gzhi snang 'char tshul|la base existentielle et son mode d'émergence en tant que phénomènes apparents
gzhi dang ngo 'phrad pa|être introduit à la base (ou au fond)
gzhi dbyings|le fond comme sphère (primordiale), la base est immensité, le domaine du fond, la base existentielle comme immensité
gzhi gnas ma'i 'od gsal|la claire lumière 'mère' qui demeure en la base (ou le fond)
gzhi ji bzhin pa|le fond tel qu'il est
gzhi lam 'bras bu|base, voie et fruit
gzhi lam gyi 'od gsal gnyis dbyer med|l'inséparabilité des deux claire lumières du fond et de la voie
gzhi med rtsa bral|sans fondement ni racine, qui n'a ni base ni source
gzhi rtsa med pa|sans fondement ni racine, qui n'a ni base ni source
gzhi nyid la grol ba|libéré en le fond en soi, libre en le fond lui-même, libéré en la base même
gzhi rig|l'intelligence du fond, l'intelligence au fond
gzhi rtsa|la base fondamentale
gzhi rtsa dngos med|qui n'a ni fondement ni substance
gzhi snang|les apparences du fond (p99), le fondement de l'être tel qu'il se manifeste
gzhi snang chen po|(tous les phénomènes sont) la manifestation suprême de la base existentielle
gzhi yi ngo bo|essence du fond
"gzhi; "|"le fond, la base, fondation, la base d'existence, la base existentielle, le fondement de l'existant ; la base fondamentale"
gzhi ma|"le fond, la base, fondation, la base d'existence, la base existentielle, le fondement de l'existant ; la base fondamentale"
gzhi mo|"le fond, la base, fondation, la base d'existence, la base existentielle, le fondement de l'existant ; la base fondamentale"
gzhi rtsa|"le fond, la base, fondation, la base d'existence, la base existentielle, le fondement de l'existant ; la base fondamentale"
gzhi'i 'od gsal|la claire lumière fond
gzhil|pression-soulagement (p30)
gzhir gnas|à demeure en la base, demeurer en le fond
gzhir gnas kyi 'od gsal|la claire lumière qui demeure comme fond (ou en le fond)
gzhir gnas kyi rig pa|intelligence immédiate qui demeure comme fond (ou en le fond)
gzhon nu bum sku|le corps vase juvénile (p105), l'omniprésent réceptacle de la nature éveillée en son éternelle fraîcheur juvénile (n341)
gzhung lugs pa|adepte de la tradition scripturaire, du courant dominant (de l'enseignement du Bouddha), adepte du courant traditionnel (ou conventionnel, officiel)
gzugs sku|corps formels
gzugs kyi sku|corps formels
gzugs su snang ba kun|tout ce qui apparaît formellement (ou comme formes)
gzung ba|grâhya, objet, ce qui est appréhendé, percevoir comme objet
gzung 'dzin|la saisie duelle, sujet et objet, perception dualiste, esprit dualiste
had de ba|état d'être suspendu, ébahi, (intelligence immédiate comme) en état de choc, sidéré, stupeur, hébété
har sangs|"grand ouvert en une brillante clarté ; grand ouvert, clair et limpide, clarté grande ouverte"
hrig ge|ouvert et lucide (p72), vigile et lucide (n219), lucidement clair et éveillé, bien (ou pleinement) éveillé, yeux grand ouverts, yeux d'un regard fixe perçant
ja' lus|le corps d'arc-en-ciel
ja' lus 'pho ba chen po|le corps d'arc-en-ciel du grand transfert
ji bzhin|tel qu'il est, ainsi tel quel, ce qui est, tel quel, tel que c'est
ji bzhin nyid|l'état d'être tel qu'il est (ou tel que c'est), simplement ce qui est
ji bzhin pa|l'état d'être tel qu'il est, (étant donné) ce qui est, tel quel
ji bzhin par bzhugs pa|demeurer en l'état d'être, tel quel, tel que c'est
ji lta ba bzhin|l'ainsité telle qu'elle est, l'état tel quel, l'état des choses telles qu'elles sont
ji lta ba gzigs pa'i ye shes|l'expérience première de l'ainsité, la gnose connaissant l'ainsité, la connaissance primordiale connaissant la nature (des phénomènes), l'intelligence première qui voit (l'esprit, ou les phénomènes) tel qu'il est, la prime expérience qui perçoit directement le sens (de l'esprit), la cognition primordiale qui expérimente (ou vit, distingue, contemple, constate) directement (l'état fondamental), connaissance qualitative, la connaissance voyant l'état (ou la nature) tel qu'il (ou elle) est
ji snyed pa mkhyen pa'i ye shes|l'expérience première des phénomènes dans leur multiplicité, la gnose connaissant la multiplicité des connaissables, connaissance quantitative, la connaissance connaissant la (pleine) quantité de tous les phénomènes (ou de tout ce qui peut être connu)
jig rten|le monde périssable, notre monde ce support dégradable (ou éphémère), le monde
jur dran|mémoires tenaces (ou rigides, endurcies)
ka dag chen po|l'expérience alpha pur totale, l'immense alpha pur
ka dag gi lam|la voie de l'alpha pur
ka dag khregs chod|l'expérience alpha pur, primordialement pure ou d'instantanéité dans laquelle la solidité de la saisie est suspendue
ka dag|alpha pur' (p72), l'état 'alpha pur' (p69), l'état originellement pur (p69), la pratique de l'alpha pur (p106), l'alpha pureté (n341), pureté primordiale
ka nas dag pa|alpha pur' (p72), l'état 'alpha pur' (p69), l'état originellement pur (p69), la pratique de l'alpha pur (p106), l'alpha pureté (n341), pureté primordiale
ka ti|Kati, le tube de cristal (reliant le cour et les yeux) (p97, n329), une nervure ou un canal cristallin et translucide reliant le cour et les yeux
ka ti shel sbug|Kati, le tube de cristal (reliant le cour et les yeux) (p97, n329), une nervure ou un canal cristallin et translucide reliant le cour et les yeux
ka ti shel sbug|Kati, le tube de cristal (reliant le cour et les yeux) (p97, n329), une nervure ou un canal cristallin et translucide reliant le cour et les yeux
ka ti shel gyi sbu gu can|Kati, le tube de cristal (reliant le cour et les yeux) (p97, n329), une nervure ou un canal cristallin et translucide reliant le cour et les yeux
rtsa ka ti|Kati, le tube de cristal (reliant le cour et les yeux) (p97, n329), une nervure ou un canal cristallin et translucide reliant le cour et les yeux
ke ta ka|le joyau Kétaka (p97, n331)
kha sbyor|le souffle d'union « l'un sur l'autre » (p30), bumchen d'union (p30), kumbhaka en union (p94), face à face en union
khad kyis drangs la|soudainement (regarder) droit devant soi (p84)
khams gsum|les trois types d'état (des demeures samsariques) (p29), les trois domaines de l'existence, les trois états d'existence, les trois plans de l'existence
khong lhod pa|être tout relaxé (p76)
khong yangs|(personne) d'esprit vaste, large d'esprit, largesse d'esprit
khor ba|le cycle, existence cyclique
khor 'das|cycle et au-delà, samsâra et nirvâna
khor 'das ru shan|la différenciation du samsâra et du nirvâna (p60), la conduite distinguant samsâra et nirvâna, la pratique de différenciation du samsâra et du nirvâna (p77)
khor 'das ru shan phye ba|la différenciation du samsâra et du nirvâna (p60), la conduite distinguant samsâra et nirvâna, la pratique de différenciation du samsâra et du nirvâna (p77)
'khor 'das ru shan 'byed pa|la différenciation du samsâra et du nirvâna (p60), la conduite distinguant samsâra et nirvâna, la pratique de différenciation du samsâra et du nirvâna (p77)
khor lo|1.roue, cercle, cycle, tourner, 2.cakra, centres corporels
khor lo bsgyur pa'i rgyal po|monarque universel
khor yug|yoga du jour et de la nuit, yoga tour du cadran (n317), continuellement, jour et nuit durant
khra khang|maison à orifices (p85)
khregs chod|trekchö, solidité suspendue (p75), suspension de la solidité (p59, n192), laisser la dureté se suspendre ou s'interrompre, relâcher les tensions, trancher à travers la rigidité
khrid|accompagner (p85), les instructions guidances (p107), instructions (p108), explications
khrid yig|manuel de transmission (p112), manuel d'instructions (manuel donnant une explication de la pratique de méditation)
khrul 'byams|profusion ordinaire des illusions, abondance (ou foisonnement, affluence) habituelle de pensées erronées, illusions galopantes, illusions endémiques
khrul 'byams tha mal du shor ba|tomber dans la profusion habituelle des illusions (ou de la confusion)
khrul gzhi|le fond de l'illusion, la base de l'illusion
'khrul pa'i gzhi|le fond de l'illusion, la base de l'illusion
khrul lam|la voie de l'illusion, le chemin de la confusion
khrul med|libre d'illusion, sans illusion
khrul pa|illusion
khrul pa'i las rgyun mi chod pa|ne pas interrompre le flux des activités confuses, ne pas faire cesser le flot des actions illusoires
khrul rtog|pensées illusionnées, pensées duelles erronées, l'illusion des pensées, pensées illusoires, pensées qui s'illusionnent, la confusion des pensées, pensées duelles confuses
khrul rtog gi rba rlabs 'tshub pa|les vagues tumultueuses de pensées illusoires, les vagues agitées de pensées qui s'illusionnent, les vagues impétueuses de la confusion des pensées duelles
khrul snang|apparences trompeuses, l'illusion des apparences, perceptions confuses, apparences illusoires
khyab bya|qui est embrassé et pénétré (p97)
khyab byed|infus, tout pénétrant (p97)
khyab gdal|déploiement à l'infini, expansivité, omniprésent, ouverture considérable, tout englobant
khyad chos|enseignement particulier
khyed mkhyen no|« Précieux (Lama) je m'en remets à vous » (p36), « Veuillez m'entendre, penser à moi, me prendre en compte/en considération »
khyer so gsum ldan|(méditer) sur les trois modes (p38, n153), les trois incorporations, les trois (points) à préserver
khyug ge|en diffusant partout (p94)
klong|sphère, immensité, étendue, vastitude, milieu
klong chen|la grande immensité, l'immense sphère, l'étendue immense
klong sde|la collection de l'Immensité, la catégorie (ou série) de l'Espace (une des trois séries de textes et d'enseignements du Dzogchen)
kun brtag ma rig pa|la non intelligence qui conçoit toute chose, l'inintelligence conceptuelle
kun tu btags pa'i ma rig pa|la non intelligence qui conçoit toute chose, l'inintelligence conceptuelle
kun byed rgyal po|le roi qui fait tout, le roi qui tout créé
kun 'byung|source de toute chose, l'origine (de tout)
kun 'byung nor bu|le joyau qui pourvoit à tout besoin
kun bzang dgongs pa|l'esprit de Samantabhadra, l'esprit de sagesse du Tout Bon, l'état primordial de Samantabhadra, l'intention éveillée du Tout Bon
"kun bzang; "|Tout Bon, Samantabhadra, le toujours bon
kun tu bzang po|Tout Bon, Samantabhadra, le toujours bon
kun 'dus pa|tout résumé
kun gyi gzhi|âlaya, fond universel, fond de tout
kun gzhi rnam shes|fond universel duel, conscience fond universel, conscience fondamentale
kun gzhi|âlaya, fond universel, fond de tout
kun gyi gzhi|âlaya, fond universel, fond de tout
kun khyab|omniprésent, présent partout
kun la khyab pa|omniprésent, présent partout
kun mkhyen|omniscient, connaissant tout
kun rdzob|relatif, d'enveloppement, (tout) l'illusoire
kun rdzob bden pa|la vérité relative
kun rtog ye shes|la prime expérience discernante, (= qui comprend en soi distinctement)
sor rtogs ye shes|la prime expérience discernante, (= qui comprend en soi distinctement)
kun tu bzang mo|Samantabhadri (nom de la sagesse primordiale), totalement positive
kun tu snang ba'i ting nge 'dzin|samâdhi de la luminosité omniprésente
la bzla ba|passé de l'autre côté (p69), s'être ainsi laissé passer (p76), transcender, aller au-delà des conceptions
la zla|passé de l'autre côté, l'expérience déterminante, l'expérience décisive
la zla ba|arriver à (ou atteindre) l'expérience décisive
la zlo ba|rester, passé de l'autre côté (p72), avoir atteint l'expérience décisive
lam|voie, chemin
lam gyi 'od gsal|claire lumière voie
lam khyer|pratique quotidienne, méditation en action, apporter (ou amener) sur la voie
lam du 'khyer ba|pratique quotidienne, méditation en action, apporter (ou amener) sur la voie
lam 'khyer|pratique quotidienne, méditation en action, apporter (ou amener) sur la voie
lam du khyer ba|pratique quotidienne, méditation en action, apporter (ou amener) sur la voie
las dang bag chags|le karma et ses potentialités (p94)
las la sbyar ba|appliquer effectivement la pratique (p105), l'application effective de la pratique (p105)
las snang|vision karmique
legs par shes pa|comprendre parfaitement
legs par zhu|faire une requête pleine et entière, de tout son cour, de tout son être
lha|divinité, déité
lhag bcas|laissé comme restes (p106)
lhag mthong|vipashyanâ, vision pénétratrante, voir clairement, profonde perspicacité (ou acuité), acuité pénétrante, vision la plus excellente, la meilleure des visions (ou perspicacités, acuités), la plus haute vision (ou acuité)
lhag pa'i rnal 'byor|Atiyoga, 'yoga d'excellence'
lha'i nga rgyal|fierté adamantine
lhan cig skyes pa'i ma rig pa|la non intelligence en laquelle nous naissons, l'inintelligence innée, ignorance spontanément née
lhan cig skyes pa'i ye shes|connaissance primordiale innée, expérience immédiate en laquelle nous naissons, gnose innée, gnose spontanément née, expérience primordiale née spontanément
lhan skyes|sahaja, inné, en lequel nous naissons, spontanément né, simultané né simultanément
lhan cig skyes pa|sahaja, inné, en lequel nous naissons, spontanément né, simultané né simultanément
lhang nge|vive et intense (p71), vividement présent, vif et resplendissant, clair et sans remous, clairement éveillé, vif (ou brillant) et alerte, d'une clarté saisissante
lhod de|tout détendu, tout relâché, tout relaxé, tout doucement, à l'aise
lhod pa|se détendre, se relaxer, se relâcher, en douceur, aise
lhod pa chen po|la grande détente, la grande relaxe (ou relaxation), totalement détendu, état de relaxation (ou détente) totale, la grande aise (syn. Dzogchen)
lhug pa|relâché dans la présence, détendu mais alerte (ou vigilant), lâché dans la présence
lhug par bzhag pa|demeurer relâché dans la présence, établi en la détente alerte (ou vigilante), (re)poser lâché dans la présence, rester détendu dans la présence
lhun grub kyi snang ba|les apparences de la clarté auto-subsistante (p99), apparences spontanément présentes, apparences de la clarté spontanément présente, manifestations de la clarté dont la présence est sans effort, manifestations de la clarté présente sans effort
lhun grub thod rgal|tögel spontané (p138), thögel de la présence spontanée
lhun grub|anâbhoga, l'autosubsistance, la pratique du spontané (p106, n341), spontanément achevé (ou apparu, parfait), spontanément présent, présence spontanée, spontanément parachevé en soi, réalisé sans effort
lhun gyis grub pa|anâbhoga, l'autosubsistance, la pratique du spontané (p106, n341), spontanément achevé (ou apparu, parfait), spontanément présent, présence spontanée, spontanément parachevé en soi, réalisé sans effort
lhun gyis|spontanément, naturellement, de soi, par soi, sans effort
lhun gyis gnas pa|se reposer spontanément, demeurer spontanément, rester (immobile, calme, tranquille, sans bouger, rester tranquille) de façon spontanée (ou naturelle), demeurer sans effort
lhun gyis 'jug pa|entrer spontanément
lhun rdzogs|perfection spontanée, parfait de soi, parfait en soi, spontanément (ou naturellement) parfait, parachèvement spontané, plénitude sans effort
lhun gyis rdzogs pa|perfection spontanée, parfait de soi, parfait en soi, spontanément (ou naturellement) parfait, parachèvement spontané, plénitude sans effort
lnga ldan 'od tu snang ba|les luminosités quinticolores apparaissent (p85)
lnga tshan lnga|les cinq séries de cinq (p108, n347)
longs sku|le corps d'expérience parfaite (p107), sambhogakâya
longs spyod rdzogs pa'i sku|le corps d'expérience parfaite (p107), sambhogakâya
lta ba|drishti, vue, façon de voir, voir
lta ba'i phyi rgya rlabs kyis gcod pa|démanteler (ou pulvériser, anéantir, défaire, abattre) les couches les plus profondes (lointaines, reculées) de sa vue
lta sgom du ro gcig|vue et méditation comme une même expérience, vue et contemplation en une seule saveur
lta sgom spyod|"vue, méditation, action ; vue, méditation, action, fruit"
lta sgom spyod 'bras bu|"vue, méditation, action ; vue, méditation, action, fruit"
lu gu rgyud|chaînettes (p84), littéralement 'file de moutons' (n263), 'files de moutons' (p84)
lugs bzhin|par le processus habituel, de façon usuelle (ou traditionnelle, conventionnelle, officielle)
lung|"1. agama, transmission, transmission scripturaire ; 2. autorisation scripturaire, autorisation"
lung khrid|transmission scripturaire expliquée (p18)
lung ma bstan|état neutre, état indéfini, état indéterminé, état morne ou terne
lung rig|écrits et raisonnement
lus bya ba la mi gnas par sdod pas 'khor ba'i 'khrul rtog dag|le corps à demeure, sans habiter dans les activités, purifie les illusions samsariques (n298)
lus bzhag stang las mi 'gul bas rtsa rlung rang dal|immobile dans la posture corporelle, les canaux subtils et les souffles sont détendus en leur état naturel (n289)
lus can|tous ceux qui ont un corps (p97)
lus ngag yid|corps, voix, esprit
lus rgya|l'enceinte corporelle (p102)
ma bcos lhan cig skyes pa|sans productions et inné, (l'état) sans artifice en lequel nous naissons, (l'état) sans fabrication en lequel nous naissons
ma bcos pa|sans artifices, sans fabrication, sans interférence, sans tentative de correction, non traité, non modifié, non corrigé, sans productions, inaltéré, non fabriqué, sans arrangement(s)
ma bu 'phrad pa|rencontre entre la (claire lumière) mère et enfant, retrouvailles mère-enfant
ma bu sbyor ba|union de (la claire lumière) mère et (la claire lumière) enfant
ma byas|incréé
ma dag las snang|visions karmiques impures
ma g.yeng ba|sans distraction, sans s'en distraire
ma 'gags pa|"anirodha, libre de tout blocage (p70, 72), illimité (p73), non entravé, pas entravé (p73), sans qu'il y ait d'interruptions (p73), librement et sans cesse (p74), sans aucun obstacle (p74), sans cessation, sans obstruction, inobstrué, incessant, sans cesse, ne pas supprimer (les objets qui se manifestent) ; sans limite (n341), sans obstruction"
mi 'gags|"anirodha, libre de tout blocage (p70, 72), illimité (p73), non entravé, pas entravé (p73), sans qu'il y ait d'interruptions (p73), librement et sans cesse (p74), sans aucun obstacle (p74), sans cessation, sans obstruction, inobstrué, incessant, sans cesse, ne pas supprimer (les objets qui se manifestent) ; sans limite (n341), sans obstruction"
gags med|"anirodha, libre de tout blocage (p70, 72), illimité (p73), non entravé, pas entravé (p73), sans qu'il y ait d'interruptions (p73), librement et sans cesse (p74), sans aucun obstacle (p74), sans cessation, sans obstruction, inobstrué, incessant, sans cesse, ne pas supprimer (les objets qui se manifestent) ; sans limite (n341), sans obstruction"
gag pa med pa|"anirodha, libre de tout blocage (p70, 72), illimité (p73), non entravé, pas entravé (p73), sans qu'il y ait d'interruptions (p73), librement et sans cesse (p74), sans aucun obstacle (p74), sans cessation, sans obstruction, inobstrué, incessant, sans cesse, ne pas supprimer (les objets qui se manifestent) ; sans limite (n341), sans obstruction"
'gag pa med par|"anirodha, libre de tout blocage (p70, 72), illimité (p73), non entravé, pas entravé (p73), sans qu'il y ait d'interruptions (p73), librement et sans cesse (p74), sans aucun obstacle (p74), sans cessation, sans obstruction, inobstrué, incessant, sans cesse, ne pas supprimer (les objets qui se manifestent) ; sans limite (n341), sans obstruction"
ma rig pa|avidyâ, ignorance, non intelligence (p29), inintelligence, nescience, non reconnaissance de l'intelligence en soi, non reconnaissance de l'auto intelligence), absence d'intelligence immédiate
ma rtsol|non recherché, sans être cherché
ma skye|non né, non produit, incréé
ma yin pa'i chos lugs|système d'organisation des phénomènes qui n'existe pas en réalité, tradition philosophique inexistante en réalité
ma'i 'od gsal|la claire lumière 'mère'
man ngag|upadesha (p19), instructions spéciales (p77), transmission directe, instruction orale secrète
man ngag gi sde|collection des Instructions spéciales, catégorie des Transmissions directes, Série des Upadesha (une des trois séries de textes et d'enseignements du Dzogchen)
mchan|note (de bas de page)
mchod brjod|stance d'offrande
mda' srong gi mig|l'oil droit comme la flèche' (p97)
mda' yab|une galerie, parapet, couverture de mur (n163)
mdangs|la brillance, lustre, teint radieux
mdo|sûtras, les discours (du Bouddha)
mdo lugs|tradition des sûtras
mdo sde spyod pa'i dbu ma|Sautrantika Madhyamika
me khyer|lucioles (signe de claire lumière, n238)
me ri 'bar ba|(charnier de) la Montagne Flamboyante (p14)
med pa|ineffabilité (au sens de brjod du med par)
med pa gsal snang|(les) manifestations (sont) clairement apparentes et pourtant ineffables
mi bsdu|ne pas concentrer (les pensées)
mi dmigs pa|"libre d'orientation, fixation sans objet, sans le cadre de référence de, sans qu'aucun cadre de référence ne s'applique ; ne peut être pensé comme étant ; libre de tout (cadre de) référence ; sans aucun point de référence ; libre de tout cadre de référence"
mi g.yo ba|acala, immobile, qui ne bouge pas, sans vaciller (de), inébranlable
ma g.yos|acala, immobile, qui ne bouge pas, sans vaciller (de), inébranlable
g.yos pa med pa|acala, immobile, qui ne bouge pas, sans vaciller (de), inébranlable
g.yo med|acala, immobile, qui ne bouge pas, sans vaciller (de), inébranlable
mi gnas|qui ne demeure nulle part, le sans demeure
mi gnas pa|qui ne demeure nulle part, le sans demeure
mi 'gul ba gsum|les trois immobilités (p90)
mi rnyed|introuvable, ne pas obtenir, non obtention, pas découvert
mi rtag pa la bsam pa|la considération de l'impermanence (p25)
mi rtog pa'i nyams|expérience de non pensée
mi rtsol|incréé
mi shigs dwangs ma chen po|l'indestructible grande quintessence (p85)
mi slob lam|la voie au-delà de l'apprentissage
mi spro|ne pas projeter, non diffusion, non prolifération (des pensées)
mig gzigs stangs las mi 'gul bas snang ba'i 'phel 'dzin|immobile dans les regards des yeux, l'augmentation de la clarté de l'apparent s'appréhende (n289)
mig mtshams|migtsam', la zone entre les sourcils (p87)
smin mtshams|migtsam', la zone entre les sourcils (p87)
mig rgyang zhags chu'i sgron ma|la luminosité aquatique qui voit loin (n297)
mig sgyu|mirage (signe de claire lumière, n238)
mkha'|espace, ciel, vastitude
mkha' bzhin ye stong|primordialement vide comme le ciel (ou l'espace)
mkha' 'gro ma|dâkinîs, dames célestes (p105)
mkhas pa|adresse, habile, érudit, rompu en, dextre, docte
mkhyen pa|connaissance, savoir
mngon dga'|La Vraie Joie' (p104) (terre pure), 'Joie Manifeste'
mngon par dga' ba|La Vraie Joie' (p104) (terre pure), 'Joie Manifeste'
mngon 'gyur|devenir manifeste, s'actualiser, mettre en évidence, effectivement vu, mettre en exergue, révéler, évident, en vrai, manifestement, véritablement, évidemment
mngon du 'gyur ba|devenir manifeste, s'actualiser, mettre en évidence, effectivement vu, mettre en exergue, révéler, évident, en vrai, manifestement, véritablement, évidemment
mngon par rdzogs par 'tshang rgya ba|la réalisation du véritable et parfait état de bouddha (p106)
mngon shes drug|les six connaissances véritables (ou authentiques)
mngon shes|abhijñâ, les connaissances véritables (p95), les connaissances authentiques (p102), vraies connaissances
mgon par shes pa|abhijñâ, les connaissances véritables (p95), les connaissances authentiques (p102), vraies connaissances
mngon sum|pratyaksha, réalité immédiate (p81), l'immédiateté (p77), manifeste, évidence sensorielle, évident pour les sens, perception
mngon sum rang thog tu dbab pa|l'arrivée en soi de l'immédiateté (p77)
mngon sum rjen pa'i ye shes|prime expérience nuement immédiate (ou nue et immédiate), expérience première dans la nudité de son immédiateté
mngon zhen|les attachements (p80), s'attacher à une réalité, prendre les choses pour réelles
"mnyam bzhag; "|samâhita, rester en contemplation (p39), rester égal en contemplation (p68, 72), l'état d'égale contemplation, (état d')équilibre, reposer en l'égalité
mnyam par bzhag pa|samâhita, rester en contemplation (p39), rester égal en contemplation (p68, 72), l'état d'égale contemplation, (état d')équilibre, reposer en l'égalité
mnyam nyid|égalité
mnyam pa nyid|égalité
mnyam pa nyid kyi ye shes|la prime expérience de l'égalité
mnyam rjes|assise et après l'assise, méditation et post-méditation
mnyam rjes kyi nyams len|la pratique de l'assise et de son après
mos gus|vénération-dévouement (p96), vénération (p98), dévotion (d'abandon dans l'inspiration)
mos pa|vivre (au sens d'expérimenter, ex. les trois portes comme les trois vajras) (p39)
mtha'|conclusion, extrême
mtha' bral|sans nom, libre de déterminations
mtha' 'das|transcendant les limites, au-delà des extrêmes
mtha' 'das pa|transcendant les limites, au-delà des extrêmes
mtha' las 'das pa|transcendant les limites, au-delà des extrêmes
mtha' dbus med pa|sans centre ni périphérie
mtha' dang dbus med|sans centre ni périphérie
mtha' grol|libre de (toute) extrême
mtha' med|sans fin, sans limite, sans limitation
mtha' rten bzhi|les quatre consolidations (n298) : 1. les trois immobilités, 2. les trois repos à demeure, 3. les trois obtentions, 4. les quatre confiances, quatre assurances
mi 'gul ba gsum|une des quatre consolidations (n298) : 1. les trois immobilités
sdod pa gsum|une des quatre consolidations (n298) : 2. les trois repos à demeure
thob pa gsum|une des quatre consolidations (n298) : 3. les trois obtentions
gding bzhi|une des quatre consolidations (n298) : 4. les quatre confiances, quatre assurances
mthar snang|visions ultimes, luminosités finales
mthar thug don|au sens ultime, la perspective ultime et parfaite, parachèvement de
mthong ba'i byin rlabs|les pouvoirs spirituels visibles (p106), les bénédictions spirituelles visibles
mthong lam|darshanamârga, la voie de la vision
mtshams sbyor|rejoindre (p104), effectuer la jonction (p104)
mtshan|1. nom (hon.), titre, 2. caractéristiques
mtshan bcas|focalisation avec objet (ou caractéristiques)
mtshan ma|signe distinctif, caractéristique conceptuelle, marque, attribut
mtshan mar 'dzin pa|saisie conceptuelle
mtshan 'dzin|saisie conceptuelle
mtshan med|"1. sans signe distinctif, absence de caractéristique propre, aconceptuel ; 2. focalisation sans objet"
mtshan ma med pa|"1. sans signe distinctif, absence de caractéristique propre, aconceptuel ; 2. focalisation sans objet"
mtshan nyid med pa|"1. sans signe distinctif, absence de caractéristique propre, aconceptuel ; 2. focalisation sans objet"
mtshan bral|"1. sans signe distinctif, absence de caractéristique propre, aconceptuel ; 2. focalisation sans objet"
mtshan nyid|caractéristique même, caractère définitif de, définition, caractéristique en soi, caractéristique propre
mtshan nyid theg pa|véhicule des caractéristiques (syn. Sûtrayâna)
mtshang yod|être lourd de conséquences (p108)
mu khyud can gyi thig le|tiglés à bordures (p88)
mu mtha' med pa|sans limite
mu stegs pa|hérétiques (se réfère aux hindouïstes, litt. 'ceux qui soutiennent des (vues) extrêmes'), extrémistes, non-bouddhistes
mu stegs rtag lta ba|la vue éternaliste des hérétiques (hindouïstes)
mun khang|cellule obscure (p98, n268)
myang 'das|nirvâna, passer au-delà de la souffrance, l'au-delà des peines
mya ngan 'das pa|nirvâna, passer au-delà de la souffrance, l'au-delà des peines
mya ngan las 'das pa|nirvâna, passer au-delà de la souffrance, l'au-delà des peines
nam mkha'|âkâsha, ciel, espace, l'élément espace
nam mkha' la zur mig hril gyis|devant soi, en une vision panoramique globale de l'espace, (à la hauteur de) l'espace devant l'on contemple avec un regard en coin, les yeux béants (p82)
nang|intérieur, interne
nang dbyings|l'immensité interne (p86)
nang gi dbyings|l'immensité interne (p86)
nang gi bla ma|Lama intérieur
nang gi dbyings rig|intelligence immédiate de l'immensité interne (p83)
nang gsal|luminosité interne, clarté intérieure
nang 'od|lumière interne, lumière intérieure
nang rgyud|tantras intérieurs
nang rtog|pensées internes
nar nar babs pa|s'écouler en un filament (p94)
ngan sngags|mantras méchants
ngan song|mauvaises destinées, renaissances défavorables, mauvaises existences, mauvaises migrations
ngang|état, sphère, (au) sein (de), disposition
ngang bskyangs|cultiver l'état, continuer en l'état, préserver l'état (de)
ngang bzhag chu bo'i rgyun gyi sgom pa|rester en l'état de méditation comme le 'courant d'une rivière' (ou comme le flux du torrent)
ngang bzhag|rester en l'état
ngang la bzhag pa|rester en l'état
ngang chen po|le grand état, état total, immense état
ngang dwangs|état de lucidité, état de transparence (innée)
ngang dvangs|état de lucidité, état de transparence (innée)
ngang gis|en lui-même, naturellement, avec évidence
ngang nas shar|apparaît au sein de
nges don|nitârtha, sens ultime, sens ultime de l'enseignement, vérité absolue ou ultime, sens certain, sens définitif, sens ultime
nges pa'i don|nitârtha, sens ultime, sens ultime de l'enseignement, vérité absolue ou ultime, sens certain, sens définitif, sens ultime
nges med|indéterminé
nges pa med pa|indéterminé
ma nges|indéterminé
ngo bo|svabhâva, état fondamental (p50), existence caractérisée par (p67), être (quelque chose) en soi (p72), essence (p73, 99), en-soi (p73), en soi-même (p76), l'essence (p86)
ngo bo gcig|unique essence, unicité en-soi, singularité d'en-soi, une même essence
ngo bo ka dag|l'en soi alpha pur, essence primordialement pure
ngo bo nyid kyi sku|Svabhavikakâya
ngo bo nyid kyis|en vertu de l'essence en elle-même
ngo bo rang bzhin thugs rje gsum|les trois aspects d'essence, nature et bonté
ngo bo sku|le corps essentiel (p106), le corps d'essence même
ngo bo nyid kyi sku|le corps essentiel (p106), le corps d'essence même
ngo bo stong pa|essence vide (p90), vide d'essence, vide par essence
ngo bos stong|essence vide (p90), vide d'essence, vide par essence
ngo gcer|l'en-soi nu (p71), essence nue
ngo rang thog tu sprad pa|Reconnaissant sa propre nature (1er vers du testament de Garab Dorjé Tshig gsum gnad rdeg) (p69), l'on est introduit directement à sa propre nature
ngo shes pa|reconnaître
ngo sprad pa|reconnaître (p73), l'introduction directe qui fait reconnaître, les introductions directes (qui font reconnaître) (p71, 107, 108), reconnaître l'état (n213), reconnaître sa propre nature (p69), présentation, reconnaître, se reconnaître, rencontrer, se rencontrer (n217)
ngo sprod|reconnaître (p73), l'introduction directe qui fait reconnaître, les introductions directes (qui font reconnaître) (p71, 107, 108), reconnaître l'état (n213), reconnaître sa propre nature (p69), présentation, reconnaître, se reconnaître, rencontrer, se rencontrer (n217)
ngo sprod pa|reconnaître (p73), l'introduction directe qui fait reconnaître, les introductions directes (qui font reconnaître) (p71, 107, 108), reconnaître l'état (n213), reconnaître sa propre nature (p69), présentation, reconnaître, se reconnaître, rencontrer, se rencontrer (n217)
ngo 'phrad pa|reconnaître (p73), l'introduction directe qui fait reconnaître, les introductions directes (qui font reconnaître) (p71, 107, 108), reconnaître l'état (n213), reconnaître sa propre nature (p69), présentation, reconnaître, se reconnaître, rencontrer, se rencontrer (n217)
ngos 'dzin pa|1. (le) reconnaissant, reconnaître (quelque chose) (p72), identifier, 2.saisir comme réel
ngos bzung|1. (le) reconnaissant, reconnaître (quelque chose) (p72), identifier, 2.saisir comme réel
nyag gcig|unicité (p42), unique
nyams|expérience
"nyams gong 'phel gyi snang ba; "|la vision (ou luminosité) de l'amplification de l'expérience (n127), (la vision de) l'amplification de la clarté des expériences (n268, 274), la vision de l'amplification des expériences (n278), la vision du développement des expériences
nyams snang gong 'phel|la vision (ou luminosité) de l'amplification de l'expérience (n127), (la vision de) l'amplification de la clarté des expériences (n268, 274), la vision de l'amplification des expériences (n278), la vision du développement des expériences
nyams gsum|les trois expériences de méditation (félicité, clarté et non pensée)
nyams khrid|instructions sur les expériences (p18), explications sur les expériences, guidance par les expériences, guidance (ou orientation) par l'expérience personnelle, accompagner à travers les expériences
nyams len|pratique
nyams su len pa|pratique
nyams myong|expérimenter
nyams snang|des expériences de clarté (p89)
nyams su len pa|pratiquer, mettre en pratique, cultiver l'expérience, faire la pratique de
nyams len|pratiquer, mettre en pratique, cultiver l'expérience, faire la pratique de
nyams zhen|attachement aux expériences
nyan thos kyi theg pa|véhicule des auditeurs véhicule des shrâvakas
nyan thos pa|auditeur, shrâvaka
nye ma mgul ba nas 'chang ba ltar|semblable à des épis tenus en gerbe, semblable à des épis tenus 'par le col' (n345)
nyi ma|lumière solaire (signe de claire lumière, n238)
nyon mongs pa|passionnel, passions, émotions conflictuelles
nyon mongs pa'i rlung|souffles passionnels
nyon mongs pa'i sgrib pa|le voile des passions
o rgyan|Oddiyâna, 'Aller en volant', 'Parti dans le ciel', 'Aller au-dessus et loin', 'Véhicule pour voler'
'od|la lumière (p86)
'od gdang|éclat lumineux (p90)
'od gsal ba'i ye shes|l'expérience primordiale de claire lumière, la connaissance première (qu'est la) claire lumière, présence d'immédiateté de (ou dans) la claire lumière, intelligence immédiate claire et lumineuse
'od gsal gyi snang ba|les apparences de claire lumière (p87), manifestations de claire lumière
'od gsal rdo rje snying po'i bstan pa|"l'enseignement de la claire lumière qui est l'essence du coeur adamantin; la claire lumière, enseignement de la quintessence de l'indestructible coeur-esprit; la claire lumière, enseignement de la quintessence du coeur-esprit éternel"
'od gsal rgyun chad med pa'i klong du|en la sphère en laquelle la claire lumière n'a de cesse (ou est continue)
'od gsal|claire lumière, clarté, présence lumineuse, lucidité totale (ou absolue)
'od gsal ba|claire lumière, clarté, présence lumineuse, lucidité totale (ou absolue)
'od khyim gyi sgron ma|la luminosité des sphères lumineuses (p83)
'od lnga'i snang ba|l'apparence des cinq lumières (p85), les apparences lumineuses quinticolores (p88)
'od lus|corps de lumière
'od zer|rais de lumière (signe de claire lumière, n238)
'og 'gyu|flux sous-jacent, courant sous-jacent, courant souterrain, flot souterrain, fond mouvant
'og 'gyu 'khrul 'byams|courant souterrain du foisonnement d'illusions habituelles, affluence sous-jacente de la confusion habituelle (ou ordinaire), flot souterrain de la profusion ordinaire des illusions, abondant flux sous-jacent de pensées erronées habituelles, fond mouvant des illusions galopantes, courant sous-jacent des illusions endémiques
'og 'gyu'i rnam rtog|flux sous-jacent du penser duel, fond mouvant du penser duel, courant sous-jacent des conceptions, courant souterrain des pensées discursives, flot souterrain de pensées dualistes
'og min|Akanishtha, le (domaine pur) Sans supérieur, le Plus haut
pha gu|pendentifs (n161)
phags yul|l'Inde, le Noble pays, la terre des  ryas
phan|oriflamme, bannière (n159)
"phar phyin drug; "|les six perfections, les six pâramitâs
pha rol tu phyin pa drug|les six perfections, les six pâramitâs
phar phyin|perfection, pâramitâ
pha rol tu phyin pa|perfection, pâramitâ
phel 'grib med|sans croissance ni décroissance, sans accroissement ni diminution, sans augmentation ni réduction
pho ba|transfert de conscience, transférer
pho ba chen po|le grand transfert
pho 'gyur med pa|immuable (p107), sans transition ni changement
phral gyi bde ba dang yun gyi bde ba la bsam pa|la considération des bonheurs temporaires et du bonheur durable (p26)
phrin las thogs med ye shes|la gnose qui ouvre sans entraves
'phro ba|projections, émissions, diffus, prolixe, éparses, parsemé, éparpillé, répandu, dispersé, dissipé, disséminé, émaner, se diffuser, proliférer, émerger (depuis le fond universel)
phro bsdu|émissions et résorptions (p51)
'phro 'du|émissions et résorptions (p51)
phro can du lus pa|la réalisation (de l'expérience) est inachevée (p106)
phro gcod|interrompre les projections (p79)
phros don|explications complémentaires (p96)
phrul ba|projeter, émaner, projections illusoires
rnam 'phrul|projeter, émaner, projections illusoires
phu kyi sba skor|"spirales d'un bouclier de jonc (p86, n271) ; bouclier de joncs (n271)"
sba phu|"spirales d'un bouclier de jonc (p86, n271) ; bouclier de joncs (n271)"
phun tshogs|sublime, tout parfait, faste
phun sum tshogs pa|sublime, tout parfait, faste
phung po|les constituants de l'expérience cognitive (p92), les constituants (n299)
phyag chen|mahâmudrâ, immense union (n80), la Grande Union
phyag rgya chen po|mahâmudrâ, immense union (n80), la Grande Union
phyag rdor|Vajrapâni, Diamant au Poing, Maître du Diamant
phyag na rdo rje|Vajrapâni, Diamant au Poing, Maître du Diamant
phyag rgya|1. mûdra, geste, symbole, sceau, 2. parèdre, partenaire
phyal ba|omniprésent, ouverture, commun
phyal yas|"ouverture expansive, expansivité ouverte ; expansion dans l'ouvert"
phyal bar yas|"ouverture expansive, expansivité ouverte ; expansion dans l'ouvert"
phyam gdal|équilibre, unité englobante, demeurer en égalité
phyam brdal|équilibre, unité englobante, demeurer en égalité
phyam gnas|d'esprit égal, équilibré, rester en équilibre, avec un esprit d'aplomb, avec un esprit pondéré, demeurer équanime, homogénéité
phyam lhod|équanime et détendu, rester tout équilibré et relaxé, tout d'équilibre dans la relaxation
phyam gnas lhod de|équanime et détendu, rester tout équilibré et relaxé, tout d'équilibre dans la relaxation
phyam me|égal et équanime (p69)
phyam phyal|"ouverture totale, ouverture ; omniprésent, ouverture, commun"
phyal ba|"ouverture totale, ouverture ; omniprésent, ouverture, commun"
phyi|externe, extérieur
phyi dar|la diffusion ultérieure du Dharma (au Tibet), la deuxième diffusion (ou propagation) du Dharma (au Tibet)
phyi nang gzung 'dzin med pa|sans objet extérieur saisi ni sujet intérieur saisisseur, n'impliquant aucune perception d'objet au-dehors ni de sujet au-dedans, n'impliquant aucune saisie duelle extérieur-intérieur, sans saisie sujet-objet dehors ou dedans
phyi nang med pa|sans extérieur ni intérieur, sans dehors ni dedans
phyi nang med par|sans extérieur ni intérieur, sans dehors ni dedans
phyi nang yul sems|objets au-dehors et esprit en-dedans
phyi 'phreng|guirlandes extérieures (p85)
phyi rgyud|tantras externes
phyi snang|apparences externes, perceptions au-dehors
phyi'i bla ma|le Lama extérieur
phyi'i dbyings|l'immensité externe (p83, 86), l'espace externe, la dimension externe
phyogs 'byams|état panoramique
phyogs med|n'est pas défini par des extrêmes, n'a pas de nature spécifique, ne connaît la division (telle que dessus ou dessous), n'implique aucune séparation directionnelle, sans orientation, impartial, sans parti pris, sans préférence
phyogs ris|orientations (p93), tout extrême ou parti pris
phyogs ris med pa|sans orientation partisane, sans position partisane, sans positionnement sectaire
phyogs zhen|ceux qu'attirent les approches inférieures
rab 'bring tha ma|capacités excellentes (ou supérieures, les meilleures), moyennes et inférieures (ou médiocres)
rab 'byams pa|infini, l'immensité de
'byams klas|infini, l'immensité de
rab tu mtho ba'i phur bu|dôme très élevé (n167)
rab tu spros med|(l'initiation) parfaitement non élaborée (p19)
rag pa'i rnam rtog|penser duel grossier, concepts vulgaires, conception superficielle, pensées discursives les plus évidentes, pensées dualistes dites grossières
rang|en soi, auto, son, personnel
rang babs|rester tel quel en l'état naturel (p74), état naturel, laisser tel quel en son état naturel (p31), (abandonné) tel quel (66), rester 'ainsi, tel quel' (p68), laisser en son état naturel (p72), tel quel en l'état naturel (p73, 75), l'état naturel tel que c'est de soi même (p75), tel que ça se présente tout naturellement (p85), être tel quel (p94), la présence d'instantanéité (n317), rester tel quel
rang babs lhug par zhog|demeurer avec douceur en (un état de) relaxation totale, rester avec douceur dans une détente absolue, se laisser choir en soi et y reposer dans la détente
rang byung|naturelle, spontanée
rang byung rig pa|intelligence spontanée
rang byung ye shes|la gnose naturelle (p79), cognition primordiale spontanée, intelligence première naturelle, prime expérience spontanée, expérience première naturelle, connaissance primordiale spontanée, présence d'immédiateté naturelle, connaissance naturelle hors du temps, connaissance (ou présence) intemporelle spontanée, intelligence immédiate spontanée
rang bzhag|établi en soi, demeurer en soi, (re)poser en soi, rester en soi, reposer naturellement,
rang gzhag|établi en soi, demeurer en soi, (re)poser en soi, rester en soi, reposer naturellement,
rang bzhin|svabhâva, nature (p73, 86), l'état présent (p99), la nature des choses, nature intrinsèque (ou inhérente, propre)
rang bzhin gnas pa'i dus|la situation présente (p103)
rang bzhin gsal ba|la clarté naturelle (p90)
rang bzhin gyis 'od gsal|être naturellement claire lumière (p97)
rang bzhin med pa|ineffable par nature, indescriptible par nature, nature inexistante, de nature non existante, sans nature propre
rang bzhin rdzogs pa chen po|la grande perfection naturelle
rang bzhin rnam dag|nature parfaitement pure, parfaitement pur par nature, parfaite pureté naturelle
rang bzhin spros bral|la simplicité naturelle libre de toute élaboration mentale (p19)
rang chas|immanent (p35)
rang chas rang la yod|être présent -  inné - en tant que qualités naturelles
rang dang 'brel ba|connecté (ou associé, lié) avec soi, trouvé en soi
rang dus|(en) le contexte naturel de, en son propre temps, le contexte en-soi
rang gcig pa|unicité en-soi, en-soi unique, singularité d'en-soi
rang gcig pu|unicité en-soi, en-soi unique, singularité d'en-soi
rang gdangs|l'éclat de l'énergie en-soi, la luminosité de l'éclat en-soi, l'énergie en-soi, naturellement radieux, rayonnement inhérent, éclat intrinsèque, éclat (ou rayonnement) inhérent translucide
rang gis rang grol|auto-libéré par soi(-même), auto-libéré en soi
rang gis rang rig pa|intelligence immédiate auto-connaissante
rang gnas chen po|la grande résidence (du dharmakâya) en place d'elle-même (p76)
rang grol|l'auto-libération (p70), libre en soi (p76)
rang gsal|sa propre clarté, lucide d'elle-même, clarté inhérente, luminosité naturelle, naturellement lucide, éclat naturel
rang gzhan gnyis su byung|émergence du moi et de l'autre comme deux
rang la byan tshud pa|expérience personnelle vécue à son propre sujet, la maîtrise obtenue par l'expérience personnelle nous concernant
rang lugs|sa propre tradition
rang ngo bskyang ba|cultiver l'état d'en-soi (p79), continuer en l'état de sa vrai nature, cultiver l'essence-même de, préserver sa propre condition, maintenir (la vision de) sa propre face, cultiver sa vraie nature, préserver son propre visage, cultiver son essence en soi (ou son essence-même)
rang ngo bskyang|cultiver l'état d'en-soi (p79), continuer en l'état de sa vrai nature, cultiver l'essence-même de, préserver sa propre condition, maintenir (la vision de) sa propre face, cultiver sa vraie nature, préserver son propre visage, cultiver son essence en soi (ou son essence-même)
rang ngo rang du phrad pa|reconnaître sa propre nature
rang ngo rang gis shes pa|ma propre face se reconnaît
rang ngo shes pa|expérimenter sa propre face
rang ngo|en soi (p90), l'essence-même de, son essence-même est, sa propre condition, sa propre face, sa vraie nature, son propre visage, son essence en soi, son essence-même
rang gi ngo bo|en soi (p90), l'essence-même de, son essence-même est, sa propre condition, sa propre face, sa vraie nature, son propre visage, son essence en soi, son essence-même
rang ngor rnam dag|l'en-soi parfaitement pur (n341), totalement pur en soi, sa propre nature en soi étant parfaitement pure, parfaitement pur par essence, totalement pur en son essence-même, pur en sa propre nature
rang rgyas gdab pa|application du sceau naturel de
rang rgyud gnyis 'dzin gyi 'ching ba las grol ba|sa propre continuité existentielle libérée des chaînes de la saisie dualiste, son continuum personnel libéré des entraves de la saisie duelle
rang rgyud|sa propre continuité existentielle (p19), son continuum personnel (p107), son propre courant de conscience, son propre courant d'existence
rang gi rgyud|sa propre continuité existentielle (p19), son continuum personnel (p107), son propre courant de conscience, son propre courant d'existence
rang rig rang gsal|l'intelligence qui se comprend en elle-même en sa propre clarté (p54), l'auto intelligence lucide d'elle-même en elle-même (p75)
rang rig|"intelligence en soi (p73), l'auto intelligence (p76), sa propre intelligence en soi ; sa propre intelligence en soi (p69)"
rang gi rig pa|"intelligence en soi (p73), l'auto intelligence (p76), sa propre intelligence en soi ; sa propre intelligence en soi (p69)"
rang rig pa|"intelligence en soi (p73), l'auto intelligence (p76), sa propre intelligence en soi ; sa propre intelligence en soi (p69)"
rang rtsal|potentialités (de mouvements) inhérentes (p74), énergie intrinsèque
rang sangs|pur en soi, naturellement purifié, cristallin en soi
rang sangs rgyas|bouddha par soi (par ses propres forces)
rang sangs rgyas kyi theg pa|véhicule des bouddhas-par-soi
rang sar grol|s'auto libère, se libère en soi, libéré en soi, libéré à sa propre place, libéré en sa propre condition
rang sar zin|rester en soi, rester à sa place (naturelle), demeurer en sa propre condition (originelle), se tenir ferme en, tenir à sa propre place, se tenir en la demeure naturelle
rang sa zin|rester en soi, rester à sa place (naturelle), demeurer en sa propre condition (originelle), se tenir ferme en, tenir à sa propre place, se tenir en la demeure naturelle
rang sor zin|rester en soi, rester à sa place (naturelle), demeurer en sa propre condition (originelle), se tenir ferme en, tenir à sa propre place, se tenir en la demeure naturelle
rang sa gzung|rester en soi, rester à sa place (naturelle), demeurer en sa propre condition (originelle), se tenir ferme en, tenir à sa propre place, se tenir en la demeure naturelle
rang sems|esprit en soi, esprit naturel, son propre esprit
rang gi sems|esprit en soi, esprit naturel, son propre esprit
rang shar|auto-émergence, apparu de soi, émergence spontanée
rang shar rang grol|sur le mode d'auto-émergences, auto-libérées (p70)
rang shes rig pa'i rgyal po|le roi intelligence immédiate qui en soi se connaît
rang snang|notre projection (p98), apparaissant en soi-même (p101), notre propre clarté (p102), l'apparent en soi (p104), mes apparences sont en soi (sans défaut), manifestations naturelles, naturellement apparent (ou manifeste), se manifestant naturellement
rang gi snang ba|notre projection (p98), apparaissant en soi-même (p101), notre propre clarté (p102), l'apparent en soi (p104), mes apparences sont en soi (sans défaut), manifestations naturelles, naturellement apparent (ou manifeste), se manifestant naturellement
rang so bzung ba|l'état - tel qu'il est - s'appréhende (p87)
rang sor klod|laisser se relaxer, se détendre à sa propre place, se relaxer en sa propre condition
rang yin pa|existence en soi, état d'existence en soi
rang yin par ngo shes pa|reconnaître comme existent en soi, reconnaître comme état d'existence en soi
rang zhal mjal ba|rencontrer le visage en soi de, rencontrer la propre face de, voir son propre visage
rdo kra ma shIrsha|pierres marbrées (n164)
rdo rje|vajra, diamant, adamantin, indestructible réalité
rdo rje 'dzin pa chen po|Grand Détenteur du Vajra, Grand Vajradhâra (p8), grand détenteur de l'indestructible réalité
rdo rje gdan|Vajrâsana, Bodhgaya, siège vajra, le Siège de diamant, siège adamantin, trône adamantin (de l'éveil)
rdo rje lu gu rgyud|chaînettes vajra (p84), littéralement 'file de moutons' (n263), 'files de moutons' vajra (p84)
rdo rje sems dpa'|Vajrasattva, l'être adamantin, Vaillant à l'esprit adamantin, Vaillant Esprit Adamantin
rdo rje slob dpon|Vajrâcharya, maître vajra
rdo rje theg pa|Vajrayâna, voie vajra, véhicule adamantin
rdo rje zam pa|le Pont Vajra
rdzogs chen pa|un pratiquant de la grande perfection
rdzogs chen sde gsum|les trois Collections (ou Séries, Catégories) de la grande perfection
rdzogs chen|mahâsandhi, la Grande Perfection
rdzogs pa chen po|mahâsandhi, la Grande Perfection
rdzogs pa|parfait, complet, plein, parachevé
rdzogs rim|phase de perfection, sampannakrama
rdzu 'phrul|riddhi, pouvoirs projectifs miracleux (p104)
rdzun snang|apparences mensongères, perceptions irréelles, perceptions illusoires
re dogs|(les saisies duelles) d'espoirs et de craintes (p93)
rgod pa|agitation
rgya grol rig pa|l'intelligence en soi libre de ses liens, l'intelligence sans entrave
rgya ma chad|sans restriction
rgya mtsho gser gyi nyi ma|l'océan de/du soleil d'or (p97, n330)
rgya yan|sans restriction, librement, sans retenue, relâché
rgya yan du ma shor bar|ne pas laisser l'esprit doucement divaguer (p93)
rgyab yig|écrits qui étayent (un enseignement, une pratique), texte qui sert d'appui, texte complémentaire
rgyal ba|le victorieux, le vainqueur
rgyal ba dgongs brgyud|la transmission par l'esprit de sagesse des vainqueurs, la lignée directe par l'expérience éveillée des bouddhas
rgyal ba rigs lnga|les bouddhas des cinq familles
rgyal po|roi
rgyal po'i gtan srid zin|atteindre (ou gagner, parvenir) le majestueux état de présence authentique
rgyal sras|enfants des vainqueurs, fils des vainqueurs, fils des victorieux, bodhisattvas
rgyal sras kyi spyod pa|la conduite des fils des victorieux, la pratique des bodhisattvas
rgyan|ornement, parure
rgyan gyi 'khor lor shar|émerger comme ornement perpétuel, apparaître comme parure continuelle
rgyang zhags chu'i sgron ma|la lampe d'eau ou luminosité aquatique lointaine (p85), la luminosité aquatique qui voit loin (p97, n330), la luminosité aquatique vue de loin (p97), la luminosité d'eau (de la vision) lointaine (n267, 268)
rgyas gdab pa|l'apposition du sceau (p62), le marquage (des apparences) (p92)
rgyu|cause
rgyu 'bras|les causes et conséquences, causalité
rgyu 'bras kyi las|les causes et conséquences de nos actes (p98), actions karmiques et leurs conséquences, causalité des actes (ou de nos actes)
rgyud|1. tantra, 2. son continuum, continuité existentielle, continuum mental, 3. continuité
rgyud bcu bdun|les 17 Tantras (du Dzogchen Upadesha)
rgyud sde|la section des tantras (les 18 Tantras du Mahâyoga)
rgyud smin|faire mûrir la continuité existentielle (ou son continuum), maturation de notre être
rgyu'i theg pa|véhicule causal
rgyu'i ting nge 'dzin|samâdhi causal
rig|la cognition (p104)
rig cha|du côté de l'intelligence première
rig dang ma rig med pa|n'a rien à voir avec la reconnaissance ou non de l'intelligence immédiate
rig 'dzin brda brgyud|transmission par symboles des détenteurs d'intelligence immédiate, lignée symbolique des vidyâdharas
rig 'dzin|vidyâdhara (p107), détenteur de gnose, détenteur d'intelligence immédiate, détenteur de l'état d'immédiateté
rig pa 'dzin pa|vidyâdhara (p107), détenteur de gnose, détenteur d'intelligence immédiate, détenteur de l'état d'immédiateté
rig ge|vigile et lucide (p70), alerte, alerte et vif
rig gsal|clarté et intelligence immédiate, claire intelligence en soi
rig gsal dbyer med|clarté et intelligence immédiate non deux (ou indissociables, inséparables)
rig ma|parèdre, femme de sagesse
rig ngor|à la lumière de l'intelligence immédiate, en l'intelligence immédiate même
rig pa|"1. vidyâ, auto intelligence (p59, 72, 74, 77), gnose (de non-saisie) (p24), intelligence immédiate (p61), l'intelligence en soi (p21, 67, 69, 77, 98),  l'état d'intelligence première (p68), intelligence immédiate en soi (p86), intelligence (p96), intelligence primordiale, se comprendre ; 2. intelligence"
rig pa dbyings kyi sgron ma|la luminosité de l'immensité d'intelligence en soi (n268)
rig pa gcer bu|"l'intelligence immédiate nue ; auto-intelligence nue (p74)"
rig pa rjen pa|"l'intelligence immédiate nue ; auto-intelligence nue (p74)"
rig pa gcer mthong|nûment voir l'intelligence immédiate, nue vision d'intelligence en soi (ou d'auto-intelligence)
rig pa ngo sprod|introduction directe à l'intelligence immédiate en soi
rig pa rang gnas|auto-intelligence en place d'elle-même, intelligence immédiate demeure en soi
rig pa rang shar|auto-intelligence auto-émergeante, intelligence immédiate apparue de soi, intelligence en soi à l'émergence spontanée
rig pa rang so zin|l'intelligence se comprend en elle-même, l'intelligence se comprenant en soi-même
rig pa tshad pheb kyi snang ba|la vision (ou luminosité) de l'authentique intelligence en soi (n127), (la vision de) l'arrivée à la perfection de l'intelligence immédiate (n268, 274, 283)
rig pa tshad 'phebs kyi snang ba|la vision (ou luminosité) de l'authentique intelligence en soi (n127), (la vision de) l'arrivée à la perfection de l'intelligence immédiate (n268, 274, 283)
rig pa zang ka ma|l'auto-intelligence telle quelle, (n'est) rien d'autre que l'intelligence immédiate, l'intelligence en soi en tant que telle, intelligence immédiate sans obstruction
rig pa zang thal gyi ngang|état d'intelligence immédiate ouverte, transparente et sans entrave, état d'ouverture transparente et sans entrave de l'intelligence en soi
rig pa zang thal|intelligence immédiate ouverte, transparente et sans entrave, ouverture transparente et sans entrave de l'état d'intelligence première (ou en soi), intelligence immédiate directement pénétrante, intelligence en soi transparente, intelligence immédiate toute-pénétrante, intelligence immédiate vigilante et pénétrante, intelligence en soi totalement ouverte, intelligence immédiate transparente et sans entrave, intelligence immédiate toute ouverte
rig pa'i zang thal|intelligence immédiate ouverte, transparente et sans entrave, ouverture transparente et sans entrave de l'état d'intelligence première (ou en soi), intelligence immédiate directement pénétrante, intelligence en soi transparente, intelligence immédiate toute-pénétrante, intelligence immédiate vigilante et pénétrante, intelligence en soi totalement ouverte, intelligence immédiate transparente et sans entrave, intelligence immédiate toute ouverte
rig pa'i gdangs|l'énergie d'intelligence en soi (p42), l'éclat de l'intelligence en soi (p70)
rig gdangs|l'énergie d'intelligence en soi (p42), l'éclat de l'intelligence en soi (p70)
rig pa'i ngang|état d'intelligence immédiate, en l'état de l'intelligence en soi
rig pa'i rang ngo shes pa|reconnaître l'intelligence en soi
rig pa'i rtsal|les potentialités de l'intelligence immédiate, l'exercice de l'intelligence en soi, le pouvoir de l'auto-intelligence, les potentialités de l'immédiateté, la manifestation (ou l'exercice, l'expression) des potentialités de la connaissance immédiate (ou de la présence d'instantanéité)
rig pa'i rtsal lhung ba|tomber dans les potentialités de l'intelligence immédiate, tomber dans le pouvoir de l'auto-intelligence
rig pa'i sgo las shar|émergence par la porte de l'intelligence immédiate, apparaît par l'avenue (ou l'accès, le portail) de l'intelligence en soi
rig pa'i ye shes|cognition primordiale auto-intelligente, intelligence première d'immédiateté (ou immédiate), prime expérience d'intelligence en soi, l'expérience primordiale de l'intelligence en soi, la gnose de l'intelligence immédiate
rig shes|une connaissance qui sait
rig stong|l'intelligence vide (p67, 76)
rig stong dbyer med|intelligence vide non deux, intelligence en soi vide indissociablement, indissociabilité d'intelligence immédiate et vide
rig stong rjen pa|intelligence immédiate vide, nue
rig stong rjes med|(l'état) d'intelligence vide sans suite (p76), l'intelligence vide qui ne laisse trace
rim gyis 'jug pa|entrer graduellement, entrer pas-à-pas
rim gyis pa|les gradualistes (n193)
rin po che 'bar ba|flamboiement de joyaux (signe de claire lumière, n238)
ris med pa|un individu non sectaire (dans sa vue), partisan (du mouvement, ou de la tradition) non sectaire
ris med|sans orientation (p70), sans différence (p72), non sectaire, sans parti pris, libre des (vues) partisanes, sans division, n'es pas divisible en, absence de division entre (ex. l'émergence des phénomènes et leur libération)
ris dang bral|sans orientation (p70), sans différence (p72), non sectaire, sans parti pris, libre des (vues) partisanes, sans division, n'es pas divisible en, absence de division entre (ex. l'émergence des phénomènes et leur libération)
rje ne|nu et dépouillé (p72)
rjes|suite, traces, après
rjes med|sans suite (p67), sans traces
rjes med rang dag|auto purifié sans laisser de traces
rjes mthun gyi thim rim|les étapes de la dissolution analogique (p100)
rjes shes|expérience subséquente (p79), compréhension (ou expérience, cognition, connaissance) résultante, conscience post-méditative
rjes spyod|les activités subséquentes (p98), conduite (ou comportement) post-méditatif
rjes su rnal 'byor|Anuyoga
rjes su rnal 'byor gyi theg pa|véhicule de l'Anuyoga
rjes thob|prishthalabdha, les circonstances après l'assise (p93), la réalisation subséquente, expérience post-méditative
rkyen|circonstance(s), circonstanciel, facteurs, conditions, aléas
rkyen du ma la bsam pa|la considération de tous les aléas (p26)
rlung|souffle(s)
rlung bum can|la respiration vase (n320)
rlung 'phel med du sdod pas rnam rtog g.yo ba'i rkyen zad|le souffle à demeure, sans amplifications, épuise les facteurs d'agitation des pensées (n298)
rlung sems|les souffles esprit (p89)
rna brgyud|lignée de (bouche à) oreille, lignée murmurée (à l'oreille)
rnal 'byor bzhi|les quatre yogas
rnal 'byor chen po|Mahayoga
rnal 'byor chen po'i rgyud kyi theg pa|véhicule du Mahayoga
rnal 'byor gyi rgyud|Yoga Tantra
rnal 'byor gyi rgyud kyi theg pa|véhicule du Yoga Tantra
rnal 'byor lam|la voie du yoga, la voie des yogis
rnal 'byor ma|yoginî
rnal 'byor pa|yogi, pratiquant (du yoga), ceux immergés en l'état d'être naturel (ou authentique)
rnal 'byor spyod pa|Yogachara, Yogacharin
rnal 'byor spyod pa'i dbu ma|Yogachara Madhyamika
rnal 'byor|yoga, union à l'état naturel, unification, immersion en l'état d'être authentique (ou naturel), union
rnal du 'byor ba|yoga, union à l'état naturel, unification, immersion en l'état d'être authentique (ou naturel), union
rnal bzhag chen po|la grande aise naturelle, l'aise naturelle suprême, le grand 'demeurer naturellement', le grand 'rester à demeure en l'état naturel', le grand état de repos naturel, le grand laisser être naturel, grande suspension impassible (ou impavide) en le naturel de l'être (ou le repos naturel), le grand repos dans la condition authentique, totalement établi en l'état naturel, le grand état naturel du repos à demeure
rnal gzhag chen po|la grande aise naturelle, l'aise naturelle suprême, le grand 'demeurer naturellement', le grand 'rester à demeure en l'état naturel', le grand état de repos naturel, le grand laisser être naturel, grande suspension impassible (ou impavide) en le naturel de l'être (ou le repos naturel), le grand repos dans la condition authentique, totalement établi en l'état naturel, le grand état naturel du repos à demeure
rnal du dbab pa|repos en l'état naturel (p80), laisser tomber en l'être authentique, tomber en l'authenticité, laisser choir en l'état naturel, doucement tomber en l'état d'être naturel
rnal ma|authentique, naturel, l'état naturel
rnam dag|parfaitement pur, pureté totale, totalement pur
rnam par dag pa|parfaitement pur, pureté totale, totalement pur
rnam dbye|distinctions
rnam pa thams cad pa|contenant tous aspects (p97), l'aspect de tous les phénomènes (p97)
rnam par dag pa'i sgron ma|la luminosité parfaitement pure (p86, 90, n268, 269)
rnam 'phrul|projections
rnam rtog grol|libérer le penser duel, libération de la pensée dualiste
"rnam rtog med pa; rnam par mi rtog pa"|nirvikalpa, l'absence de penser duel (p29), sans pensées discursives, sans concepts, sans conception, absence de pensées dualistes, sans pensées
rnam rtog ngo shes pa|reconnaître les pensées (duelles)
rnam rtog|vikalpa, penser duel, concepts, conception, pensées discursives, pensées dualistes, pensées
rnam par rtog pa|vikalpa, penser duel, concepts, conception, pensées discursives, pensées dualistes, pensées
rnam shes|vijñâna, conscience (duelle), cognition dualiste, connaissance de (quelque chose), expérience duelle
rnam par shes pa|vijñâna, conscience (duelle), cognition dualiste, connaissance de (quelque chose), expérience duelle
rnga yab|éventail fait d'une queue de yak (n160)
rnying ma pa|Nyingmapas, la tradition (ou école) des mantras (ou tantras) Anciens, l'école Ancienne, l'école des Anciens
ro gcig|ekarasa, être la même expérience que (Vairocana) (p105), saveur unique, l'état de n'être qu'une seule saveur, être d'une seule saveur, goût unique
ro langs|zombie, mort vivant
ro snyoms|samarasa, saveur égale, même saveur (ou goût), saveur identique, égalité de saveur, le processus de rendre tout(e chose) d'une même saveur
rol pa|une manifestation (p101), se manifester, déploiement
rol pa ci shar yang|quelle que soit la manifestation qui émerge (ou apparaisse), peu importe ce qui apparaît comme manifestation, indépendamment de ce qui émerge comme manifestation, sans distinction eu égard aux manifestations qui apparaissent
rol pa nges med|la manifestation est indéterminée
rol pa'i rtsal|les potentialités de la manifestation, l'exercice de la manifestation, le pouvoir de la manifestation, les potentialités de la manifestation, l'exercice (ou l'expression) des potentialités de la manifestation
rol pa rtsal|les potentialités de la manifestation, l'exercice de la manifestation, le pouvoir de la manifestation, les potentialités de la manifestation, l'exercice (ou l'expression) des potentialités de la manifestation
rtag chad|être et non être, éternité et néant, éternalisme et nihilisme
rtag lta ba|la vue éternaliste, éternalisme, vision de la permanence
rtags|les signes (de succès des pratiques) (p96), indication
rtags tshad|les signes (de succès des pratiques) et leurs évaluations (p96)
rten|support (p97)
rten 'brel|circonstances adéquates (p22), facteur propice (p24)
rtog med ye shes|la prime expérience aconceptuelle
rtog med|"aconceptuel (p69), sans pensées discursive, non pensée ; non pensée, non discursif, sans pensées, non conceptuel ; la non pensée, n'impliquant pas de concept (de)"
rtog pa med pa|"aconceptuel (p69), sans pensées discursive, non pensée ; non pensée, non discursif, sans pensées, non conceptuel ; la non pensée, n'impliquant pas de concept (de)"
mi rtog pa|"aconceptuel (p69), sans pensées discursive, non pensée ; non pensée, non discursif, sans pensées, non conceptuel ; la non pensée, n'impliquant pas de concept (de)"
rtog pa|penser duel, conceptuel, pensée discursive, penser, pensée
rtog tshogs|schémas conceptuels
rtogs pa|comprendre directement (p69), compréhension, réalisation
rtsa|canal, artère, nâdi, veine
rtsa ba|source, racine, fondamental
rtsa ba'i bla ma|Lama racine, Lama source
rtsa rlung|canaux et souffles
rtsa rlung thig le|les canaux, les souffles et les bindus, le corps, le souffle et l'esprit (p29), nâdî, prâna (ou vâyu) et bindu, tsa-lung-tiglé (n76)
rtsa rlung thig le'i rnal 'byor|yogas des canaux, souffles et bindus, yoga des tsa-lung-tiglé
rtsal|exercices (p72), le pouvoir (p106), potentiel, potentialités, les ouvres, énergie, énergie créatrice, expressions (de), énergie dynamique (de), dynamisme (de)
rtsal rdzogs|parachèvement des potentiels (de), perfection de l'énergie dynamique (de), perfection du dynamisme de
rtsal sbyang|développer ses potentialités (p83)
rtsal sbyong|exercice (de la pratique)
rtsal snang|les exercices des apparences (p73), les apparences sont manifestations des potentialités (de l'esprit) (p73), les apparences se manifestent comme exercice de leurs potentialités, apparences issues de l'exercice des potentialités (p74)
rtse gcig|tikagrata, uniquement tout avec lui (p65), tout à ça - sans s'en distraire (p88), tout à ça (p103), en un point, une seule chose à la fois, tout absorbé en un seul point, en unicité, 'one point only', 'onepointedness', uniquement (n175)
rtsibs shar gyen 'greng|des rais (quinticolores) dressés (p88, n280)
rtsol med|non contraint, l'état sans effort, l'état libre d'effort, sans effort, sans qu'il n'y ait aucun effort à faire
rtsol med kyi bstan pa|l'enseignement de l'état non contraint
rtsol sgrub|chercher la réalisation, effort et accomplissement, rechercher et accomplir
rtsol zhing sgrub pa|chercher la réalisation, effort et accomplissement, rechercher et accomplir
ru log|renversement, interversion, revirement, le processus de renversement de la matière solide en énergie rayonnante
ru shan|différentiation, distinction, séparation, division (n228), les exercies de rushen
sa|terre, degré, niveau, état
sa bcu|les dix terres, dix bhûmis
sa gcig pa|terre unique, unique état
sa gter|trésor de la terre, terma terrestre
sa lam|les degrés et chemins (p106)
sa le ba|en l'état clair et vide (p94), lucide et clair, clarté vive et cristalline, vif et ouvert, vivide et ouvert, vividement clair
sa le ba'i ngang du|en le contexte d'une ouverture vive et cristalline (ou vivide)
sal le|claire (et) brillant (p74)
sang nge|dégagé et transparent (p69, 70), ouvert et dégagé (p72), ouvert et translucide
sangs rgyas|l'état d'éveil, bouddha, un être éveillé
sangs rgyas kyi yon tan la brten nas|(l'entraînement de l'esprit) basé sur les qualités de Bouddha (p28)
sangs rgyas pa|s'éveiller, obtenir (ou devenir, atteindre) bouddha
sbyin pa|générosité, don
sbyong lam|la voie de la purification
sbyor lam|la voie de la jonction, voie de l'union, voie de l'approche
sbyor sgrol|rites sexuels et rites meurtriers
sdod pa gsum gyis tshad gzung|les trois repos à demeure en lesquels est appréhendé l'état véritable (p91)
sems|citta, esprit (p21, 59, 98), pensées, processus de pensée, le penser, esprit ordinaire
sems bskyed|bodhicittotpâda, engendrer bodhicitta, générer (ou susciter, cultiver, produire, stimuler, concevoir) l'esprit d'éveil (ou l'éveil de l'esprit du cour, le cour-esprit éveillé, le cour-esprit d'éveil)
byang chub sems bskyed|bodhicittotpâda, engendrer bodhicitta, générer (ou susciter, cultiver, produire, stimuler, concevoir) l'esprit d'éveil (ou l'éveil de l'esprit du cour, le cour-esprit éveillé, le cour-esprit d'éveil)
sems 'byung|caitta, occurrences de l'esprit, événements de la cognition, ce qui apparaît à l'esprit, apparition mentale, émergence de l'esprit, contenu de l'esprit
sems byung|caitta, occurrences de l'esprit, événements de la cognition, ce qui apparaît à l'esprit, apparition mentale, émergence de l'esprit, contenu de l'esprit
sems bzo med la mi 'gul bas dbyings rig zung du chud par byed|immobile en l'état de non fabrication de l'esprit, l'union de l'immensité et de son intelligence se réalise (n289)
sems can|sattva, les vivants, êtres sensibles
sems 'dzin|les fixations de l'esprit (p80), méditation, le cour de la méditation, tenir ou poser l'esprit, tenir l'esprit (en l'expérience stable d'une seule chose) (n175)
sems grol|libérer l'esprit, libérer l'esprit mental (ou pensant)
sems klong man ngag|les collections (ou catégories, séries) de l'Esprit, de l'Immensité (ou de l'Espace) et des Instructions spéciales (ou des Transmissions Directes)
sems klong man ngag gi sde|les collections (ou catégories, séries) de l'Esprit, de l'Immensité (ou de l'Espace) et des Instructions spéciales (ou des Transmissions Directes)
sems kyi gnas lugs|le sens de l'esprit, disposition essentielle de l'esprit, condition naturelle de l'esprit, mode d'être de l'esprit
sems kyi ngo bo|l'essence de l'esprit
sems kyi snang ba|manifestation de l'esprit, perception de l'esprit, perception, apparences de l'esprit, les claires apparences de l'esprit, les apparences de clarté de l'esprit
sems kyi yal ba|la dissolution (ou effacement, évanouissement, disparition) des activités mentales
sems las 'das pa|au-delà de l'esprit ordinaire, transcender l'esprit ordinaire (ou confus, duel, illusionné)
sems las 'das pa'i ye shes|intelligence première au-delà de l'esprit ordinaire, expérience primordiale qui transcende l'esprit ordinaire (ou confus, duel, illusionné)
sems nyid|cittatâ, l'esprit en soi, la nature de l'esprit
sems nyid kyi rang zhal bsgribs|voiler le visage même de l'esprit en soi, obscurcir le visage en soi de l'esprit en soi, obscurcir la propre face de la nature de l'esprit
sems pa|l'activité de l'esprit (p99), activité mentale
sems phyogs|enseignements appartenant à la collection de l'Esprit
sems rang bzhag gnyug ma'i ngang bskyangs|cultiver (ou continuer, préserver, maintenir) l'état naturel de l'esprit établi en soi (ou qui demeure en soi, qui repose en soi, qui reste en soi, posé en soi)
sems rgyud|continuité existentielle d'esprit, continuum mental, continuum mental personnel, son esprit - son courant de conscience, son esprit et courant d'existence, son esprit : ce continuum d'existence
sems sbyong|apprentissage spirituel, entraînement de l'esprit (n82)
sems sde|la collection (ou catégorie, série) de l'Esprit (une des trois séries de textes et d'enseignements du Dzogchen)
sems snang|esprit ordinaire et phénomènes apparents, esprit ordinaire et apparences phénoménales
sems tsam|Cittamâtra, l'enseignement 'Rien qu'esprit', 'l'Esprit seul(ement)'
sems tsam pa|Cittamâtrin, un pratiquant de l'enseignement 'Rien qu'esprit', 'l'Esprit seul(ement)'
sgo gsum gyi sngon 'gro|les préparations des trois portes (p109)
sgom lam|voie de l'habitude, voie de la méditation, voie de la pratique
sgom pa nyams su len pa tshul|méthode de pratique de la méditation
sgom pa|bhâvanâ, la familiarisation (p87), se vit (p103), la pratique, entraînement, méditation, cultiver
bsgom pa|bhâvanâ, la familiarisation (p87), se vit (p103), la pratique, entraînement, méditation, cultiver
sgom pa'i shes rab|compréhension issue de la méditation (sur les enseignements)
sgom byung gi shes rab|compréhension issue de la méditation (sur les enseignements)
sgra can|éclipse (signe de claire lumière, n238)
sgra 'od zer|sonorités, lumières et rayons (p101)
sgra tshig tha snyad kun las 'das pa|au-delà de toute expression et description conventionnelle
sgrib pa|voile, obscurcissement
sgrib pa gnyis|le double voile
sgrims lhod med pa|sans tension ni relâchement
sgrims lhod med par|sans tension ni relâchement
sgro 'dogs|le surimposé, superfétations, surimposition, exagérations, 'coller des plumes', 'en rajouter'
sgro 'dogs gcod pa|éliminer les conceptions illusoires (semblables aux plumes du pigeon) (p100), éliminer les superfétations, éliminer les projections conceptuelles surimposées (à la réalité en soi), « couper les plumes » (n336), supprimer le surimposé, que les superfétations soient éliminées
sgro skur|ajouts et dénis, affirmer ou nier, exagération de l'existence ou de la non existence, éxagération dans l'affirmation ou la négation de l'existence, affirmation de l'existence de ce qui n'est pas et négation de l'existence de ce qui est
sgro skur 'das pa|au-delà des ajouts et dénis, au-delà des exagérations de l'existence ou de la non existence, au-delà d'affirmer ou de nier
sgrol ba|1.délivrer, libérer, 2.rites de délivrance ou de libération (impliquant de tuer des malfaisants)
sgron ma|la lampe (p85), la luminosité (p85, 86)
sgron ma drug|les six lampes
sgron ma rnam bzhi|les quatre luminosités (n268), les quatre lampes
sgrub brgyud|lignée des accomplis, lignée de l'accomplissement, lignées de la pratique
sgrub mi dgos pa|pas besoin de créer, nul besoin d'accomplir (ou d'atteindre)
sgrub pa|s'efforcer pour atteindre (l'éveil), pratiquer, accomplir
sgrub pa bka' brgyad|les pratiques des huit logos
sgrub pa po|sâdhaka, pratiquant d'un sâdhana
sgrub sde|la section des sâdhanas (du Mahâyoga)
sgrub thabs|sâdhana, méthode d'accomplissement
sgyu lus|mâyâdeha, le corps d'illusion(s) (p89), corps illusoire
sgyu ma'i lus|mâyâdeha, le corps d'illusion(s) (p89), corps illusoire
sgyu ma|illusoire, illusion magique, mirage
sgyur ba|transformer
sgyur lam|voie de la transformation
shar ba|émerger, s'éveiller, apparaître, émergence
shar grol|émergence-libération, libre dès l'apparition, libération sur (ou dès l')émergence
shar grol ris med|sans distinction entre apparition (ou émergence) et libération
shes bya ji snyed pa mkhyen pa'i ye shes|l'expérience première des phénomènes dans leur multiplicité, la gnose connaissant la multiplicité des connaissables, connaissance quantitative, la connaissance connaissant la (pleine) quantité de tous les phénomènes (ou de tout ce qui peut être connu)
shes bya'i sgrib pa|voile du connu, voile de la connaissance duelle, voile de la dualité, voile de la cognition duelle
shes pa|l'expérience (p30), expérimenter, expérimentateur, la cognition (p66), être conscient, savoir, conscience
shes pa rang sor klod pa|laisser l'expérience se relaxer en soi
shes rab|prajñâ, compréhension, intelligence, sublime connaissance, sagesse discriminante
shes rab phar phyin|perfection de sagesse, prajnâpâramitâ
shes rab kyi pha rol tu phyin pa|perfection de sagesse, prajnâpâramitâ
shes rab rang byung gi sgron ma|"la luminosité de (la) compréhension naturelle spontanée (p90, n268) ; la luminosité de la compréhension naturelle spontanée qui est alpha pure intelligence immédiate en soi"
ka dag rig pa shes rab rang byung gi sgron ma|"la luminosité de (la) compréhension naturelle spontanée (p90, n268) ; la luminosité de la compréhension naturelle spontanée qui est alpha pure intelligence immédiate en soi"
shes rgyud|vijñânasantâna, continuité existentielle de conscience, continuum cognitif
shes rig|intelligence connaissante
shin tu rnal 'byor|Atiyoga, 'yoga extrême'
shin tu rnal 'byor gyi theg pa|véhicule de l'Atiyoga
shin tu rnam dag dwang ma chen po'i dbu ma|(les deux) 'Umas aux grandes sèves extrêmement pures' (p97)
shin tu spros med|(l'initiation) complètement non élaborée (p19)
shog ser|papier ou feuilles d'or
sib kyis|venir doucement (se fondre) (p105)
sib sib|venir doucement (se fondre) (p105)
skar ma|étoiles (signe de claire lumière, n238)
sku|Corps
sku dang gdung|corps et reliques de celui-ci (p106)
sku gsum|les trois corps, le trikâya, les trois dimensions
sku gsung thugs|"corps, voix et esprit ; corps, parole et esprit éveillés"
skye 'gags med pa|sans origine ni cessation, absence de création ou de cessation, ne naissent ni ne cessent, ne viennent ni à naître ni à disparaître, sans naissance ni mort, sans début ni fin
skye ba med dang 'gags pa med pa|sans origine ni cessation, absence de création ou de cessation, ne naissent ni ne cessent, ne viennent ni à naître ni à disparaître, sans naissance ni mort, sans début ni fin
skye gnas med pa|être sans origine ni durée, ne naissent ni ne demeurent, sans naissance ni demeure
skye ba med dang dnas pa med|être sans origine ni durée, ne naissent ni ne demeurent, sans naissance ni demeure
skye med|l'absence de création (n341), sans origine, sans naissance, non produit, qui ne vient pas à l'existence, sans apparition
skye ba med pa|l'absence de création (n341), sans origine, sans naissance, non produit, qui ne vient pas à l'existence, sans apparition
skyel ma lta bu|qui accompagne (p100)
smin grol|transmissions et instructions (p111) (qui mènent notre continuité existentielle, ou continuum personnel, à) la maturation et la libération
smon lam btab pa|faire des voux, invocation d'aspiration, l'expression de ses souhaits, l'action d'invocation, l'invocation de ses souhaits
smon lam|aspiration, souhaits, voux, invocation d'aspiration, l'expression de ses souhaits, l'action d'invocation, l'invocation de ses souhaits
smon lam btab pa|aspiration, souhaits, voux, invocation d'aspiration, l'expression de ses souhaits, l'action d'invocation, l'invocation de ses souhaits
sna tshogs|varié, diversité, multiplicité, bigarré, divers, toutes sortes de
sna tshogs rdo rje|double vajra, vajra multiple
snam bu|les tissus (p101)
snang ba|les apparences (p89), l'apparence de clarté (p101), les manifestations (p108), les clartés apparentes, la claire apparence (n285), vision, apparaître, se manifester, être visible, l'aspect manifeste de, phénomènes apparents, perception
snang ba bzhi|les quatre visions (p34, 77, 87), les quatre luminosités (n127, 274), les quatre apparences de clarté (n274), l'apparent (n289)
snang bzhi|les quatre visions (p34, 77, 87), les quatre luminosités (n127, 274), les quatre apparences de clarté (n274), l'apparent (n289)
snang ba rnam pa bzhi|les quatre visions (p34, 77, 87), les quatre luminosités (n127, 274), les quatre apparences de clarté (n274), l'apparent (n289)
snang ba 'dar 'phring med par sdod pas zhing khams tshad la phebs par byed|les apparences à demeure, sans fluctuation, amènent la perfection des domaines purs (n298)
snang ba rgya yan|les apparences s'élèvent librement
snang ba'i 'char cha|l'apparition des clartés émergentes (p86)
snang 'char tshul|le mode d'apparition des choses, la façon dont les apparences s'élèvent (ou se présentent, s'expriment, se manifestent, se révèlent, jaillissent, surgissent, se montrent, émergent)
snang sems|les apparences-esprit, ce qui apparaît à l'esprit
snang srid 'khor 'das|le monde des apparences phénoménales que ce soit du samsâra ou du nirvâna, le monde manifeste - qu'il soit samsâra ou nirvâna
snang srid|toute possibilité d'apparence, le monde phénoménal apparent, le monde phénoménal de tous les possibles, les apparences phénoménales constituant le monde manifeste, le monde des apparences et de tous les possibles, = le monde périssable, notre monde ce support dégradable (ou éphémère), le monde, = habitacle-habitant, le monde et les vivants, l'univers
snang zhing srid pa|toute possibilité d'apparence, le monde phénoménal apparent, le monde phénoménal de tous les possibles, les apparences phénoménales constituant le monde manifeste, le monde des apparences et de tous les possibles, = le monde périssable, notre monde ce support dégradable (ou éphémère), le monde, = habitacle-habitant, le monde et les vivants, l'univers
snang zhing srid pa'i chos|toute possibilité d'apparence, le monde phénoménal apparent, le monde phénoménal de tous les possibles, les apparences phénoménales constituant le monde manifeste, le monde des apparences et de tous les possibles, = le monde périssable, notre monde ce support dégradable (ou éphémère), le monde, = habitacle-habitant, le monde et les vivants, l'univers
snang tshad srid tshad|toute possibilité d'apparence, le monde phénoménal apparent, le monde phénoménal de tous les possibles, les apparences phénoménales constituant le monde manifeste, le monde des apparences et de tous les possibles, = le monde périssable, notre monde ce support dégradable (ou éphémère), le monde, = habitacle-habitant, le monde et les vivants, l'univers
'jig rten|toute possibilité d'apparence, le monde phénoménal apparent, le monde phénoménal de tous les possibles, les apparences phénoménales constituant le monde manifeste, le monde des apparences et de tous les possibles, = le monde périssable, notre monde ce support dégradable (ou éphémère), le monde, = habitacle-habitant, le monde et les vivants, l'univers
snod bcud|toute possibilité d'apparence, le monde phénoménal apparent, le monde phénoménal de tous les possibles, les apparences phénoménales constituant le monde manifeste, le monde des apparences et de tous les possibles, = le monde périssable, notre monde ce support dégradable (ou éphémère), le monde, = habitacle-habitant, le monde et les vivants, l'univers
snang stong|apparence vide, phénomènes apparents et vacuité
snang stong dbyer med|apparence vide non deux, apparence vide indissociable, l'inséparabilité des apparences et de la vacuité
snang yul|les objets (d'un monde extérieur) apparaissent, objets apparents, objets qui se manifestent
snang ba'i yul|les objets (d'un monde extérieur) apparaissent, objets apparents, objets qui se manifestent
yul snang|les objets (d'un monde extérieur) apparaissent, objets apparents, objets qui se manifestent
snga dar|la première diffusion du Dharma au Tibet
snga 'gyur|premières traductions, traductions de la première époque, traductions initiales, traductions pionnières
snga 'gyur lnga|les cinq premières traductions (du Dzogchen)
sngags|mantra, parole efficiente, charme
sngags gsar ma|les tantras (ou la tradition des mantras) Nouveaux, les tantras Récents (ou Modernes)
sngags lugs|la tradition des mantras, la tradition des tantras
sngags nang pa|les tantras (ou la tradition des mantras) Internes, les tantras du Dedans
sngags pa|mantrika, pratiquant mantrique (ou tantrique)
sngags rnying ma|les tantras (ou la tradition des mantras) Anciens, les tantras de l'école Ancienne
sngar 'dris kyi ye shes|une prime expérience déjà rencontrée, une cognition primordiale rencontrée auparavant
sngon 'gro|préliminaires (p108), pratique préliminaire, section préliminaire
snod bcud|habitacle-habitant, le monde et les vivants, l'univers
snyan brgyud|tradition orale, lignée de transmission orale
snyen brgyud|tradition orale, lignée de transmission orale
snying gi bu|fils de cour
snying gtam|conseils du cour, recommandations du fond du cour
snying po|1. cour, hridaya, le cour même de, le cour essentiel, 2. embryon, garbha, matrice, 3. essence, sâra, essence du cour, essence-même, l'âme, 4. esprit, citta
snying po med pa|être sans substance (p98), insubstantiel, sans essence, creux
snying rje|bon cour (p96), compassion, bonté
snying thig|Nyingtig, l'essence du cour de l'esprit, l'Essence de l'Esprit, quintessence du cour, quintessence du cour-esprit
snying thig pa|pratiquant des Nyingtig
snying thig rdo rje snying po'i lam|"les Nyingtig, voie de l'essence du coeur adamantin ; les Nyingtig, voie de la quintessence du coeur-esprit éternel ; les Nyingtig, voie de la quintessence de l'indestructible coeur-esprit "
snying thig ya bzhi|Nyingtig Yashi, le Nyingtig 'quatre en deux paires', les quatre branches du Nyingtig (p112, 117, n1, n62)
so sa'i gling|Sosaling (un charnier en Inde)
so so rang rig|intelligence en soi individuelle, sa propre auto intelligence, sa propre intelligence en soi individuelle
so so'i mos ngor|en fonction des diverses réceptivités (des êtres ordinaires) (p107)
so sor rtogs pa'i shes rab|l'intelligence qui comprend en soi distinctement (n268)
so sor snang ba|claires apparences individuelles, apparaître distinctement, (se) manifester de façon distincte
sor bzhag|l'immédiateté naturelle (p76), qui reste tel quel (p76), le tel quel (p75)
spang blang bral thob med|sans rejet, saisie, perte ni gain
"spang blang med pa; "|sans rejet ni saisie
spong len med pa|sans rejet ni saisie
spang blang mi bya|sans fuir ni suivre (l'émotion)
spangs thob med pa|non-renonciation ou accomplissement
spong lam|la voie du renoncement
sprin|nuage (signe de claire lumière, n238)
spro bsdu med pa|sans émission et résorption (des pensées), sans la diffusion-absorption des pensées, sans l'allée et venue des pensées, sans le mouvement centrifuge-centripète (du mental)
spros bcas|(l'initiation) élaborée (p19)
spros bral|nisprapañca, libre de toute conception (p14), libre d'élaborations conceptuelles (p87), libre de toutes les déterminations (p93), l'état sans élaboration (p95), l'état transcendant toutes conceptions (p103), l'état transcendant les élaborations (p103), (la réalité) aconceptuelle
spros dang bral ba|nisprapañca, libre de toute conception (p14), libre d'élaborations conceptuelles (p87), libre de toutes les déterminations (p93), l'état sans élaboration (p95), l'état transcendant toutes conceptions (p103), l'état transcendant les élaborations (p103), (la réalité) aconceptuelle
spros pa dang bral ba|nisprapañca, libre de toute conception (p14), libre d'élaborations conceptuelles (p87), libre de toutes les déterminations (p93), l'état sans élaboration (p95), l'état transcendant toutes conceptions (p103), l'état transcendant les élaborations (p103), (la réalité) aconceptuelle
spros med|aprapañca, (l'initiation) sans élaboration (p19)
spros pa|prapañca, les fabrications (p108), projection, élaboration (mentale), émanation, conception, émission, activité (mentale) multiple
spros pa can|(les pratiquants) aimant les fabrications (p108), ceux enclins aux élaborations conceptuelles
sprul bsgyur|manifester (quelque chose, au cours du rêve) (p95), apparitions et transformation (du yoga du rêve), déploiement émané (ou manifesté)
sprul pa|nirmita, émanation, projection
sprul sku|Nirmânakâya
spyan lnga|les cinq yeux
spyi 'byams|1.habitudes irrégulières (dans la méditation), 2.universel, continuel, tout englobant
spyi 'byams gshis shor|s'écarter de l'état fondamental à cause d'un manque d'habitude dans la familiarisation, s'éloigner de l'état fondamental à cause de mauvaises habitudes (irrégularité)
spyi gzhi|le fond global, le fond commun, la base générale
spyi mes chen po|le grand ancêtre universel
spyi'i rnam bzhag|les différents modes généraux de présentation (p107)
spyod pa|conduite, action
spyod pa'i rgyud|Charyâ Tantra
spyod pa'i rgyud kyi theg pa|véhicule du Charyâ Tantra
spyod yul|domaine d'activité, domaine d'expérience, dimension de l'expérience, sphère d'action, domaine d'agissement
srid pa|existence, devenir, samsâra, existence conditionnée
srid pa bar do|le bardo de l'existence en devenir (p105)
srid pa'i bar do|le bardo de l'existence en devenir (p105)
srog rtsa|le canal de vie (p97), l'artère vitale
stong cha|du côté du vide
stong gsal|vide et pourtant lucide (ou lumineux, clair), vacuité et lucidité (ou luminosité, clarté)
stong nyid kyi gshis|état fondamental qui est vacuité
stong nyid snying rje zung 'jug|union de vacuité et compassion
stong pa|shûnya, le vide, absence, sans, dépourvu de, ouverture, évacuer, disparaître, être vide
stong pa lhun grub|vide et pourtant spontané, vide mais spontané, vide et spontané
stong pa nyid|shûnyatâ, la vacuité, l'état sans (nature en propre), état d'ouverture
stong pa'i ngang|l'état du vide, la sphère du vide
stong pa'i sgron ma|la luminosité du vide (p90)
sun ma lta bu|qui vient à notre rencontre (p100)
tha dad med pa|non différent, sans séparation
tha le|ouvert et dégagé (p104), ouverture lucide
tha mal gyi rig pa|l'intelligence ordinaire naturelle (p70), l'intelligence immédiate 'ordinaire'
tha mal gyi shes pa|la cognition ordinaire naturelle (p70), 'l'esprit ordinaire'
tha snyad|concepts, termes, expressions, terminologie
thabs|moyen, upâya (p30), moyen habile
thabs lam|la voie des méthodes (p50), voie des moyens habiles
thag bcad pa|décider, trancher, être certain de, déterminer de façon décisive, trancher à l'instant même
kho thag chod|décider, trancher, être certain de, déterminer de façon décisive, trancher à l'instant même
thag gcig thog tu bcad pa|Certain de l'unique conclusion (2ème vers du testament de Garab Dorjé) (p70), décider de façon définitive en cet état unique
the tshom med|sans doute(s), sans hésitation, sans ambivalence
theg chen|le grand véhicule
theg pa chen po|le grand véhicule
theg dman|le petit véhicule
theg pa dman pa|le petit véhicule
theg chung|le petit véhicule
theg mchog|le suprême véhicule
theg pa|véhicule(s)
theg pa dgu|les neuf véhicules
theg pa rim dgu|les neuf véhicules
theg pa rim dgu'i rtse bo|le sommet (ou pinnacle, faîte) des neuf véhicules
theg pa thams cad kyi rtse rgyal|la cime victorieuse de tous les véhicules (d'éveil), le sommet de la victoire parmi tous les véhicles, le zénith victorieux de tous les véhicules (d'éveil)
theg pa'i yang rtse|le plus haut sommet des véhicules (d'éveil), la cime des cimes des véhicules (d'éveil)
thig le|bindu, point essentiels vitaux, points, nucleus, essence (n177), tiglé, sphère, minuscule sphère
thig le chen po|le grand bindu, la grande sphère essentielle
thig le nyag gcig|le bindu d'unicité (p42), la sphère unique, unique essence
thig le stong pa'i sgron ma|la luminosité des tiglés du vide (p86, 88, n268, 270), la luminosité des tiglés vides (n268), la lampe des sphères vides
thig le stong sgron|la luminosité des tiglés du vide (p86, 88, n268, 270), la luminosité des tiglés vides (n268), la lampe des sphères vides
thod rgal|Tögel, traversée (directe) du crâne, libération spontanée, 'traversée directe, libératrice et spontanée de l'ignorance crânienne' (p138) (traductions existantes par ailleurs cf NM p138)
thod rgal ba|subit instable, avec des hauts et des bas (n193), les instantanés instables, qui atteignent le résultat par sauts (ou bonds), (ceux dont les qualités d'expérience et de réalisation accroissent ou décroissent sans ordre séquentiel)
thog|dans l'instantanéité de, dans l'immédiateté (ou l'imminence)
thog ma'i sangs rgyas|le(s) bouddha(s) primordiaux, bouddha de toute origine
thol byung blo rdeg|frapper soudainement la pensée, ferrer subito une pensée, asséner un coup subit à la pensée, assommer instantanément une pensée, porter un coup preste à une pensée
thos pa'i shes rab|compréhension issue de l'écoute (des enseignements)
thugs|citta, esprit, esprit de sagesse, esprit éveillé, esprit des bouddhas, esprit du Lama, coeur
thugs rje|karunâ, qualités (p73), qualités de bonté (p86), l'énergie de toutes les qualités éveillées (p90), qualités éveillées (p97), les potentialités de bonté (p97), la bonté (p104), l'énergie d'éveil (p106), l'immense bonté (p106), l'énergie de grande bonté, compassion, énergie
thugs sras|fils de cour
thun|séance (de pratique), session (d'assise), période de pratique
thun dang thun mtshams|sessions et intersessions
thun mong gi drod rtags|les signes habituels de succès des pratiques (p108)
thun mong gi gdul bya|les êtres ordinaires (p107), les apprentis ordinaires
ting 'dzin sems pa|samâdhi sattva, l'être de samâdhi (p39), divinité d'absorption méditative
ting nge 'dzin sems pa|samâdhi sattva, l'être de samâdhi (p39), divinité d'absorption méditative
ting nge 'dzin|samâdhi, état d'absorption de l'esprit, absorption spirituelle, absorption méditative, état de contemplation, contemplation
ting nge 'dzin chen po|grand samâdhi, samâdhi suprême
tshad|mesure, critère, (quelque chose de) complet, évaluation, appréhender, la perfection de
tshad med|sans mesure, incommensurable, illimité
tshad med bzhi|les quatre (pensées) incommensurables
tshang sprugs pa|complet en désordre (p108)
tshi chad pa|tomber dans le désespoir, découragement
tshig dbang|l'initiation du verbe (ou du mot)
tshogs bsags|(les pratiques de) développement des domaines (p109)
tshogs drug|les six domaines (de la conscience), les six aggrégats de la conscience, les six modes de (la) conscience
rnam shes tshogs drug|les six domaines (de la conscience), les six aggrégats de la conscience, les six modes de (la) conscience
tshogs gnyis|double développement (de vertu et de gnose), les deux développements
tshogs lam|la voie du développement (des deux domaines)
tshul|les circonstances (p106), méthode, manière, mode
tshul khrims|shîla, discipline, éthique, bonne moralité, moralité
tsit ta|le cour (physique)
tsit ta sha'i sgron ma|la luminosité du cour de chair
'ub chub|plénitude, être pleinement englobé (ou compris), tout résumé et parfait, réuni ensemble dans la réalisation, tout inclus dans la plénitude totale
wal le|"1. brillant et scintillant (p69, 70), dégagé, ardent et vibrant (p74), vivide et vibrant, brillant et vivide ; 2. Soudai ; 3. non concret"
wal le ba|"1. brillant et scintillant (p69, 70), dégagé, ardent et vibrant (p74), vivide et vibrant, brillant et vivide ; 2. Soudai ; 3. non concret"
wa le|"1. brillant et scintillant (p69, 70), dégagé, ardent et vibrant (p74), vivide et vibrant, brillant et vivide ; 2. Soudai ; 3. non concret"
yab|sire, père
yab yum|dame et sire (p36), père/mère, (un yidam) accompagné, avec sa dame (n144)
yab dang yum|dame et sire (p36), père/mère, (un yidam) accompagné, avec sa dame (n144)
yad yud|(rester) de façon instable (p104), mouvement confus et vacillant, bref et instantané, inconstant, volage, changeant et capricieux
yan pa|vide et absent (p74)
yang dag par rdzogs pa'i sangs rgyas|la pure et parfaite réalisation de l'état de bouddha (p106)
yang gsang thig le|le tiglé le plus secret (p59), l'essence la plus secrète, le point essentiel le plus secret
yang gsang ba thig le|le tiglé le plus secret (p59), l'essence la plus secrète, le point essentiel le plus secret
yang rab|individu de la plus haute des capacités supérieures, individu de potentiel extrêmement élevé (ou le plus remarquable, le plus grand, le plus éminent)
yang rtse|le plus haut sommet, la cime des cimes
yangs pa|spacieux, vaste et spacieux, large, ouvert, dégagé
yangs pa chen po|grande vastitude, grande (étendue) vaste et spacieuse, grande ouverture dégagée
ye babs sor bzhag|le tel quel de l'avènement primordial (p75)
ye bzhin ma bcos|sans fabrication tel que cela a toujours été, sans artifices ab initio, non modifié tel que c'est depuis toujours
ye dag|pur depuis toute origine, primordialement pur, pureté intemporelle
ye nas dag pa|pur depuis toute origine, primordialement pur, pureté intemporelle
ye grol|libération primordiale (p74), libre depuis l'origine (p76), primordialement libre (p93)
ye gzhi|le fond primordial, le fond premier, la base immédiate, l'intemporelle base d'existence, le fondement intemporel de l'existence
ye gzhi snying po byang chub kyi sems|l'esprit d'éveil (bodhicitta) - ce cour essentiel du fond primordial, le cour du fond intemporel (étant) le cour-esprit éveillé
ye ji bzhin pa|l'état primordial du simplement tel que c'est, le prime état (du) tel quel, l'ainsité telle quelle depuis toute origine, l'ainsité primordiale
ye med|non existant depuis le tout début, intemporellement inexistant, intemporellement absent, primordialement inexistant, non existant depuis l'origine
ye nas|depuis toute origine, primordialement, intemporel, de toute éternité
ye nas lhun grub|primordialement spontané, autosubsistence depuis toujours, intemporellement et spontanément présent, primordialement et spontanément présent, intemporellement autosubsistant, autosubsistant depuis l'origine
ye nas mnyam pa|égalité primordiale, égal depuis toute origine
ye nas sangs rgyas pa|"éveillé depuis toujours, éveillé depuis l'origine, intemporellement éveillé, primordialement éveillé ; l'état à jamais éveillé"
ye sangs|"éveillé depuis toujours, éveillé depuis l'origine, intemporellement éveillé, primordialement éveillé ; l'état à jamais éveillé"
ye phyi mo|la grandmère primordiale
ye rdzogs|parfait à jamais, primordiale perfection, perfection originelle, parfait depuis l'origine, parfait dès le début, intemporellement parfait, perfection intemporelle
ye nas rdzogs pa|parfait à jamais, primordiale perfection, perfection originelle, parfait depuis l'origine, parfait dès le début, intemporellement parfait, perfection intemporelle
ye re|ouvert et clair (p70), ouvert et dégagé (p72)
ye sangs|l'état à jamais éveillé
ye shes brjod bral|inexprimable connaissance primordiale, expérience immédiate sans mots
ye shes bzhi|les quatre gnoses, quatre types d'expériences primordiales (extérieure, intérieure, secrète et d'ainsité) (n337)
ye shes kyi rang rtsal du bskyong ba|cultiver (ou préserver, continuer, maintenir) le potentiel inhérent (ou en soi) de l'expérience primordiale, cultiver les potentialités inhérentes de la connaissance première
ye shes kyi rlung|jñâna vâyu, souffle(s) d'intelligence première, souffle(s) de gnose
ye shes kyi sku|jñânakâya, corps d'expérience première, corps d'intelligence immédiate, corps de cognition primordiale
ye shes kyi snang ba|les apparences d'expérience immédiate (p82)
ye shes kyi tshogs|(développement du) domaine de l'expérience première, développement (ou domaine) de connaissance primordiale
ye shes lnga|les cinq intelligences premières (: la prime expérience discernante, (= qui comprend en soi distinctement), la prime expérience de clarté, la prime expérience de l'égalité, la gnose qui ouvre sans entraves, la prime expérience aconceptuelle)
ye shes sems dpa'|jñânasattva, l'être de gnose première (p39), l'être d'intelligence immédiate (ou primordiale, première), l'être de prime intelligence
ye shes sems pa|jñânasattva, l'être de gnose première (p39), l'être d'intelligence immédiate (ou primordiale, première), l'être de prime intelligence
ye shes spyi|connaissance première générale (ou universelle)
ye shes zang thal|expérience primordiale ouverte, transparente et sans entrave, ouverture transparente et sans entrave de la prime intelligence
ye shes|jñâna, cognition primordiale (p69), intelligence première, prime expérience, expérience première, connaissance primordiale, présence d'immédiateté, connaissance hors du temps, connaissance (ou présence) intemporelle, intelligence immédiate
ye nas shes pa|jñâna, cognition primordiale (p69), intelligence première, prime expérience, expérience première, connaissance primordiale, présence d'immédiateté, connaissance hors du temps, connaissance (ou présence) intemporelle, intelligence immédiate
ye stong yongs stong|primordialement et totalement (ou complètement) vide
ye stong|vide depuis toute origine, primordialement vide, vide intemporel, vide depuis toujours
ye nas stong pa|vide depuis toute origine, primordialement vide, vide intemporel, vide depuis toujours
ye yod|existant depuis le tout début, intemporellement existant, intemporellement présent, primordialement existant, existant depuis l'origine
ye zin chos|les phénomènes sont déjà tels qu'ils sont
yi dam|deva, devatâ, déité d'élection (p102), yidam, déité personnelle, déité tutellaire, sa déité de méditation
yid|manas, mental (conceptuel), esprit discursif, esprit fonctionnel
yid ches pa|croyance
yid dpyad|analyse mentale, examiné par l'intellect
yid kyi rnam rtog|manovijñâna, penser duel cogitateur, concepts mentaux, conception mentale, pensées discursives produite par le mental, pensées dualistes de l'esprit discursif
yid kyis 'grogs pa|assimiler en un (certain) état d'esprit
yid la byed pa|"1. l'attention, faire attention ; 2. manasikâra, activité mentale, mentaliser, faire avec le mental, former des idées (à propos de)"
yid la mi byed pa|"1. inattention, ne pas prêter attention à ; 2. sans activité mentale, sans mentalizer, sans faire avec le mental, sans former des idées (à propos de)"
yin lugs|état d'existence naturel, mode d'être, façon d'être, état
yo langs|état sans blocage ni interruption, nature libre et sans cesse, état sans interruption ni blocage (du dharmakâya), état, nature, jeu
yod med|existence et non existence, être ou ne pas être, être et non être
yod pa|(quelque chose qui) existe, exister (p67), être là
yongs grub|parinishpanna, parfaitement établi, nature complètement établie, nature ultimement existente (des phénomènes) pleinement accompli, pleinement réalisé, pleinement avéré, totalement confirmé, incontestable
yongs su grub pa|parinishpanna, parfaitement établi, nature complètement établie, nature ultimement existente (des phénomènes) pleinement accompli, pleinement réalisé, pleinement avéré, totalement confirmé, incontestable
yongs rdzogs|paripûrna, complètement parfait, parachèvement, totalement complet, en intégralité, absolument complet
yongs su rdzogs pa|paripûrna, complètement parfait, parachèvement, totalement complet, en intégralité, absolument complet
yul|objets
yul can|sujet, celui qui perçoit
yul dbang|impressions sensorielles
yul rkyen|circonstances d'objets (p85)
yul sems bar|(dans) 'l'intervalle' entre les objets et l'esprit
yul sems bar med|sans séparation entre les objets et l'esprit
yul sems gnyis med|objets et esprit non deux, sans qu'esprit et objets ne soient deux
yul sems snang ba kun|tout ce qui apparaît (extérieurement ou intérieurement :) objets ou esprit, tout ce qui se manifeste que ce soit objets ou esprit
yul sems gang snang|tout ce qui apparaît (extérieurement ou intérieurement :) objets ou esprit, tout ce qui se manifeste que ce soit objets ou esprit
yul snang chos kun|tous les phénomènes se manifestant comme objects
yum|dame, mère
za 'og ris|les dessins de brocards (multicolores) (p85)
za zi|(les apparences) nébuleuses (p102), désorienté
zab khrid|profonde transmission
zad pa'i chos nyid mthong ba|voir la réalité de l'épuisement en soi, voir la réalité en soi de l'épuisement (ou de la cessation) des phénomènes, voir la réalité de la résolution en soi des phénomènes
zad sa|le point de résolution, le point d'épuisement, où (les phénomènes) sont résolus (ou dissous, épuisés)
zag med|non souillé (p81), non polluée, sans impureté (passionnelle)
zag pa med pa|non souillé (p81), non polluée, sans impureté (passionnelle)
zag pa med pa'i dbyings|l'ouverture non souillée, l'immensité non polluée, la sphère sans impureté (passionnelle)
zang ka|"1. tel quel, nu, ce qui simplement est ; 2. inobstrué"
zang ka ma|"1. tel quel, nu, ce qui simplement est ; 2. inobstrué"
zang thal rjen pa|ouverture transparente et nue (p93)
zang thal rjen pa'i rig pa|intelligence immédiate ouverte, transparente, nue et sans entrave, ouverture transparente, nue et sans entrave de l'état d'intelligence en soi
zang thal|sans entrave, ouverture transparente (p93), pénétration directe, transparent, tout-pénétrant, une vigilance pénétrante, totalement ouvert, transparence sans entrave, grand ouvert
zang ma thal 'byung|sans entrave, ouverture transparente (p93), pénétration directe, transparent, tout-pénétrant, une vigilance pénétrante, totalement ouvert, transparence sans entrave, grand ouvert
zang thal le|sans entrave, ouverture transparente (p93), pénétration directe, transparent, tout-pénétrant, une vigilance pénétrante, totalement ouvert, transparence sans entrave, grand ouvert
zang nge thal le|sans entrave, ouverture transparente (p93), pénétration directe, transparent, tout-pénétrant, une vigilance pénétrante, totalement ouvert, transparence sans entrave, grand ouvert
zhal 'chems|dernières instructions, ultime testament, dernières paroles
zhal gdams|instructions orales importantes, recommandations importantes, directives de méditation, consignes et conseils (pour la pratique), exhortations essentielles, enseignement oral, conseils
zhal lung|instructions orales, enseignement (hon.), instructions du Lama
zhal sgom|instructions orales et pratique assise (ou contemplative)
zhar byung|addendum, annexe
zhe sdang|aversion, haine répulsion, animosité, inimitié, agressivité, emportement haineux, détestation, ressentiment
zhen pa|attachement
zhen snang|(les illusions d')apparences (adventices) procédant d'attachements (p78)
zhi ba|1. paix, paisible, pacification, apaisement, se calmer, calme, tranquillité, sérénité, quiétude, repos, 2. paix ultime, nirvâna
zhi gnas|Shamatha, shiné, calme mental, calmer l'esprit, l'état de calme paisible, atteindre le calme pacifié (ou paisible)
zhi khro|(déités) paisibles et courroucées
zhi lhag dbyer med|calme mental et vision pénétrante non deux (ou indissociables), shiné et lhagtong indissociables
zhing|domaine pur (p83), champs (d'éveil)
zhing khams|domaine pur (p83), champs (d'éveil)
zhugs|entrer (p101), rentrer, participer
zim bu|(les yeux) mi clos (p82, 83)
zin pa|terminé, fini, accompli, fait
zla ba|lumière lunaire (signe de claire lumière, n238)
zlum khrigs|arrangement circulaire (p88)
zung 'jug|yuganaddha, l'union (p101), unification, uni
zung du 'jug pa|yuganaddha, l'union (p101), unification, uni
zur la bltas|regarder ou contempler en coin (p84)
zur rgyan|éléments connexes (p111)
byang chub|éveil
dpe ji ltar 'khrul na|Quelle métaphore illustrerait la manière dont ils illusionnés ?

